Abklingendes Blut=[Abklingendes Blut](talente/abklingendes-blut.md)
Abklingen=[Abklingen](talente/abklingen.md)
Aderschlitzer=[Aderschlitzer](talente/aderschlitzer.md)
Adlergestalt=[Adlergestalt](talente/adlergestalt.md)
Akrobat=[Akrobat](talente/akrobat.md)
Alchemie=[Alchemie](talente/alchemie.md)
Arkane Explosion=[Arkane Explosion](talente/arkane-explosion.md)
Ausweichen=[Ausweichen](talente/ausweichen.md)
Bändiger=[Bändiger](talente/baendiger.md)
Bärengestalt=[Bärengestalt](talente/baerengestalt.md)
Beschwörer=[Beschwörer](talente/beschwoerer.md)
Beute schätzen=[Beute schätzen](talente/beute-schaetzen.md)
Bildung=[Bildung](talente/bildung.md)
Blitzmacher=[Blitzmacher](talente/blitzmacher.md)
Blocker=[Blocker](talente/blocker.md)
Blutige Heilung=[Blutige Heilung](talente/blutige-heilung.md)
Blutschild=[Blutschild](talente/blutschild.md)
Brutaler Hieb=[Brutaler Hieb](talente/brutaler-hieb.md)
Charmant=[Charmant](talente/charmant.md)
Dämonenbrut=[Dämonenbrut](talente/daemonenbrut.md)
Dämonenzauber=[Dämonenzauber](talente/daemonenzauber.md)
Dämonen zerschmettern=[Dämonen zerschmettern](talente/daemonen-zerschmettern.md)
Diebeskunst=[Diebeskunst](talente/diebeskunst.md)
Diener der Dunkelheit=[Diener der Dunkelheit](talente/diener-der-dunkelheit.md)
Diener des Lichts=[Diener des Lichts](talente/diener-des-lichts.md)
Einbetten=[Einbetten](talente/einbetten.md)
Einstecker=[Einstecker](talente/einstecker.md)
Elementare Bündeln=[Elementare Bündeln](talente/elementare-buendeln.md)
Elementen Trotzen=[Elementen Trotzen](talente/elementen-trotzen.md)
Elementare bündeln=[Elementare Bündeln](talente/elementare-buendeln.md)
Elementen trotzen=[Elementen Trotzen](talente/elementen-trotzen.md)
Explosionskontrolle=[Explosionskontrolle](talente/explosionskontrolle.md)
Feuermagier=[Feuermagier](talente/feuermagier.md)
Fieser Schuss=[Fieser Schuss](talente/fieser-schuss.md)
Fieser Schuß=[Fieser Schuß](talente/fieser-schuss.md)
Flink=[Flink](talente/flink.md)
Friedvoller Hieb=[Friedvoller Hieb](talente/friedvoller-hieb.md)
Frontheiler=[Frontheiler](talente/frontheiler.md)
Fürsorger=[Fürsorger](talente/fuersorger.md)
Genesung=[Genesung](talente/genesung.md)
Gerüstet=[Gerüstet](talente/geruestet.md)
Gezieltes Gift=[Gezieltes Gift](talente/gezieltes-gift.md)
Glückspilz=[Glückspilz](talente/glueckspilz.md)
Handwerk=[Handwerk](talente/handwerk.md)
Heimlichkeit=[Heimlichkeit](talente/heimlichkeit.md)
Heldenglück=[Heldenglück](talente/heldenglueck.md)
Herausforderer der Elemente=[Herausforderer der Elemente](talente/herausforderer-der-elemente.md)
Herr der Elemente=[Herr der Elemente](talente/herr-der-elemente.md)
Hinterhältiger Angriff=[Hinterhältiger Angriff](talente/hinterhaeltiger-angriff.md)
Homunkulus=[Homunkulus](talente/homunkulus.md)
Ich muss weg!=[Ich muss weg!](talente/ich-muss-weg.md)
In Deckung=[In Deckung](talente/in-deckung.md)
Instrument=[Instrument](talente/instrument.md)
Jäger=[Jäger](talente/jaeger.md)
Kämpfer=[Kämpfer](talente/kaempfer.md)
Kann ich mal vorbei?=[Kann ich mal vorbei?](talente/kann-ich-mal-vorbei.md)
Kletterass=[Kletterass](talente/kletterass.md)
Knechtschaft=[Knechtschaft](talente/knechtschaft.md)
Kraft der Bestie=[Kraft der Bestie](talente/kraft-der-bestie.md)
Kreiszeichner=[Kreiszeichner](talente/kreiszeichner.md)
Langfinger=[Langfinger](talente/langfinger.md)
Macht des Blutes=[Macht des Blutes](talente/macht-des-blutes.md)
Mächtige Beschwörung=[Mächtige Beschwörung](talente/maechtige-beschwoerung.md)
Mächtige Erweckung=[Mächtige Erweckung](talente/maechtige-erweckung.md)
Mächtige Herbeirufung=[Mächtige Herbeirufung](talente/maechtige-herbeirufung.md)
Magieresistent=[Magieresistent](talente/magieresistent.md)
Manipulator=[Manipulator](talente/manipulator.md)
Meister aller Klassen=[Meister aller Klassen](talente/meister-aller-klassen.md)
Meister seiner Klasse=[Meister seiner Klasse](talente/meister-seiner-klasse.md)
Meucheln=[Meucheln](talente/meucheln.md)
Nekromantie=[Nekromantie](talente/nekromantie.md)
Panzerung zerschmettern=[Panzerung zerschmettern](talente/panzerung-zerschmettern.md)
Parade=[Parade](talente/parade.md)
Perfektion=[Perfektion](talente/perfektion.md)
Präziser Schuss=[Präziser Schuss](talente/praeziser-schuss.md)
Prügler=[Prügler](talente/pruegler.md)
Raserei=[Raserei](talente/raserei.md)
Reiten=[Reiten](talente/reiten.md)
Ritual der Narben=[Ritual der Narben](talente/ritual-der-narben.md)
Rundumschlag=[Rundumschlag](talente/rundumschlag.md)
Runenkunde=[Runenkunde](talente/runenkunde.md)
Rüstträger=[Rüstträger](talente/ruesttraeger.md)
Rüstzauberer=[Rüstzauberer](talente/ruestzauberer.md)
Salve=[Salve](talente/salve.md)
Sattelschütze=[Sattelschütze](talente/sattelschuetze.md)
Scharfschütze=[Scharfschütze](talente/scharfschuetze.md)
Schlachtruf=[Schlachtruf](talente/schlachtruf.md)
Schlitzohr=[Schlitzohr](talente/schlitzohr.md)
Schlossknacker=[Schlossknacker](talente/schlossknacker.md)
Schmerzhafter Wechsel=[Schmerzhafter Wechsel](talente/schmerzhafter-wechsel.md)
Schnelle Reflexe=[Schnelle Reflexe](talente/schnelle-reflexe.md)
Schütze=[Schütze](talente/schuetze.md)
Schutz vor Elementen=[Schutz vor Elementen](talente/schutz-vor-elementen.md)
Schwimmen=[Schwimmen](talente/schwimmen.md)
Sehnenschneider=[Sehnenschneider](talente/sehnenschneider.md)
Sensenspötter=[Sensenspötter](talente/sensenspoetter.md)
Spruchmeister=[Spruchmeister](talente/spruchmeister.md)
Stabbindung=[Stabbindung](talente/stabbindung.md)
Standhaft=[Standhaft](talente/standhaft.md)
Talente=[Talente](talente.md)
Teufelchen=[Teufelchen](talente/teufelchen.md)
Tiergestalt=[Tiergestalt](talente/tiergestalt.md)
Tiermeister=[Tiermeister](talente/tiermeister.md)
Tod entrinnen=[Tod entrinnen](talente/tod-entrinnen.md)
Todeskraft=[Todeskraft](talente/todeskraft.md)
Totenrufer=[Totenrufer](talente/totenrufer.md)
Umdenken=[Umdenken](talente/umdenken.md)
Unersättliches Beschwören=[Unersättliches Beschwören](talente/unersaettliches-beschwoeren.md)
Untote Horden=[Untote Horden](talente/untote-horden.md)
Untote zerschmettern=[Untote zerschmettern](talente/untote-zerschmettern.md)
Verdrücken=[Verdrücken](talente/verdruecken.md)
Vergeltung=[Vergeltung](talente/vergeltung.md)
Verheerer=[Verheerer](talente/verheerer.md)
Verletzen=[Verletzen](talente/verletzen.md)
Vernichtender Schlag=[Vernichtender Schlag](talente/vernichtender-schlag.md)
Vertrautenband=[Vertrautenband](talente/vertrautenband.md)
Vertrauter=[Vertrauter](talente/vertrauter.md)
Waffenkenner=[Waffenkenner](talente/waffenkenner.md)
Waffenloser Meister=[Waffenloser Meister](talente/waffenloser-meister.md)
Wahrnehmung=[Wahrnehmung](talente/wahrnehmung.md)
Wechsler=[Wechsler](talente/wechsler.md)
Wissensgebiet=[Wissensgebiet](talente/wissensgebiet.md)
Zauber auslösen=[Zauber auslösen](talente/zauber-ausloesen.md)
Zaubermacht=[Zaubermacht](talente/zaubermacht.md)
Zauberqual=[Zauberqual](talente/zauberqual.md)
Zauberroutine=[Zauberroutine](talente/zauberroutine.md)
Zauberwaffe=[Zauberwaffe](talente/zauberwaffe.md)
Zehrender Spurt=[Zehrender Spurt](talente/zehrender-spurt.md)
Zwei Waffen=[Zwei Waffen](talente/zwei-waffen.md)
Allheilung=[Allheilung](zauber/allheilung.md)
Arkanes Schwert=[Arkanes Schwert](zauber/arkanes-schwert.md)
Balancieren=[Balancieren](zauber/balancieren.md)
Bannen=[Bannen](zauber/bannen.md)
Blenden=[Blenden](zauber/blenden.md)
Blitz=[Blitz](zauber/blitz.md)
Blut kochen=[Blut kochen](zauber/blut-kochen.md)
Botschaft=[Botschaft](zauber/botschaft.md)
Dämonen beschwören=[Dämonen beschwören](zauber/daemonen-beschwoeren.md)
Dämonenzauber=[Dämonenzauber](talente/daemonenzauber.md)
Duftnote=[Duftnote](zauber/duftnote.md)
Durchlässig=[Durchlässig](zauber/durchlaessig.md)
Durchsicht=[Durchsicht](zauber/durchsicht.md)
Ebenentor=[Ebenentor](zauber/ebenentor.md)
Einschläfern=[Einschläfern](zauber/einschlaefern.md)
Elementar herbeirufen=[Elementar herbeirufen](zauber/elementar-herbeirufen.md)
Erdspalt=[Erdspalt](zauber/erdspalt.md)
Federgleich=[Federgleich](zauber/federgleich.md)
Feueratem=[Feueratem](zauber/feueratem.md)
Feuerball=[Feuerball](zauber/feuerball.md)
Feuerlanze=[Feuerlanze](zauber/feuerlanze.md)
Feuerstrahl=[Feuerstrahl](zauber/feuerstrahl.md)
Feuerwand=[Feuerwand](zauber/feuerwand.md)
Flackern=[Flackern](zauber/flackern.md)
Flammeninferno=[Flammeninferno](zauber/flammeninferno.md)
Flammenklinge=[Flammenklinge](zauber/flammenklinge.md)
Fliegen=[Fliegen](zauber/fliegen.md)
Fluch=[Fluch](zauber/fluch.md)
Freund=[Freund](zauber/freund.md)
Frostschock=[Frostschock](zauber/frostschock.md)
Frostwaffe=[Frostwaffe](zauber/frostwaffe.md)
Gasgestalt=[Gasgestalt](zauber/gasgestalt.md)
Geben und Nehmen=[Geben und Nehmen](zauber/geben-und-nehmen.md)
Gehorche=[Gehorche](zauber/gehorche.md)
Giftbann=[Giftbann](zauber/giftbann.md)
Giftschutz=[Giftschutz](zauber/giftschutz.md)
Glühender Glaube=[Glühender Glaube](zauber/gluehender-glaube.md)
Halt=[Halt](zauber/halt.md)
Heilbeeren=[Heilbeeren](zauber/heilbeeren.md)
Heilende Aura=[Heilende Aura](zauber/heilende-aura.md)
Heilende Hand=[Heilende Hand](zauber/heilende-hand.md)
Heilendes Feld=[Heilendes Feld](zauber/heilendes-feld.md)
Heilendes Licht=[Heilendes Licht](zauber/heilendes-licht.md)
Heilende Strahlen=[Heilende Strahlen](zauber/heilende-strahlen.md)
Heiliger Hammer=[Heiliger Hammer](zauber/heiliger-hammer.md)
Kettenblitz=[Kettenblitz](zauber/kettenblitz.md)
Kleiner Terror=[Kleiner Terror](zauber/kleiner-terror.md)
Kontrollieren=[Kontrollieren](zauber/kontrollieren.md)
Körperexplosion=[Körperexplosion](zauber/koerperexplosion.md)
Kriegszauberer=[Kriegszauberer](charaktere-heldenklassen-kriegszauberer.md)
Lauschen=[Lauschen](zauber/lauschen.md)
Licht=[Licht](zauber/licht.md)
Lichtlanze=[Lichtlanze](zauber/lichtlanze.md)
Lichtpfeil=[Lichtpfeil](zauber/lichtpfeil.md)
Lichtsäule=[Lichtsäule](zauber/lichtsaeule.md)
Magie bannen=[Magie bannen](zauber/magie-bannen.md)
Magie entdecken=[Magie entdecken](zauber/magie-entdecken.md)
Magie identifizieren=[Magie identifizieren](zauber/magie-identifizieren.md)
Magische Barriere=[Magische Barriere](zauber/magische-barriere.md)
Magische Rüstung=[Magische Rüstung](zauber/magische-ruestung.md)
Magisches Schloss=[Magisches Schloss](zauber/magisches-schloss.md)
Magische Waffe=[Magische Waffe](zauber/magische-waffe.md)
Manabrot=[Manabrot](zauber/manabrot.md)
Nahrung zaubern=[Nahrung zaubern](zauber/nahrung-zaubern.md)
Netz=[Netz](zauber/netz.md)
Niesanfall=[Niesanfall](zauber/niesanfall.md)
Öffnen=[Öffnen](zauber/oeffnen.md)
Putzteufel=[Putzteufel](zauber/putzteufel.md)
Reinigen=[Reinigen](zauber/reinigen.md)
Rost=[Rost](zauber/rost.md)
Rüstzauberer=[Rüstzauberer](talente/ruestzauberer.md)
Schatten erwecken=[Schatten erwecken](zauber/schatten-erwecken.md)
Schatten=[Schatten](zauber/schatten.md)
Schattenklinge=[Schattenklinge](zauber/schattenklinge.md)
Schattenlanze=[Schattenlanze](zauber/schattenlanze.md)
Schattenpfeil=[Schattenpfeil](zauber/schattenpfeil.md)
Schattensäule=[Schattensäule](zauber/schattensaeule.md)
Schleudern=[Schleudern](zauber/schleudern.md)
Schutzfeld=[Schutzfeld](zauber/schutzfeld.md)
Schutzkuppel=[Schutzkuppel](zauber/schutzkuppel.md)
Schutzschild dehnen=[Schutzschild dehnen](zauber/schutzschild-dehnen.md)
Schutzschild stärken=[Schutzschild stärken](zauber/schutzschild-staerken.md)
Schutzschild=[Schutzschild](zauber/schutzschild.md)
Schweben=[Schweben](zauber/schweben.md)
Schweig=[Schweig](zauber/schweig.md)
Segen=[Segen](zauber/segen.md)
Skelette erwecken=[Skelette erwecken](zauber/skelette-erwecken.md)
Spionage=[Spionage](zauber/spionage.md)
Springen=[Springen](zauber/springen.md)
Spurt=[Spurt](zauber/spurt.md)
Steinwand=[Steinwand](zauber/steinwand.md)
Stolpern=[Stolpern](zauber/stolpern.md)
Stossgebet=[Stossgebet](zauber/stossgebet.md)
Tanz=[Tanz](zauber/tanz.md)
Tarnender Nebel=[Tarnender Nebel](zauber/tarnender-nebel.md)
Telekinese=[Telekinese](zauber/telekinese.md)
Teleport=[Teleport](zauber/teleport.md)
Terror=[Terror](zauber/terror.md)
Tierbeherrschung=[Tierbeherrschung](zauber/tierbeherrschung.md)
Tiere besänftigen=[Tiere besänftigen](zauber/tiere-besaenftigen.md)
Totengespräch=[Totengespräch](zauber/totengespraech.md)
Trugbild=[Trugbild](zauber/trugbild.md)
Unsichtbares Sehen=[Unsichtbares sehen](zauber/unsichtbares-sehen.md)
Unsichtbares sehen=[Unsichtbares sehen](zauber/unsichtbares-sehen.md)
Unsichtbarkeit=[Unsichtbarkeit](zauber/unsichtbarkeit.md)
Verborgenes sehen=[Verborgenes sehen](zauber/verborgenes-sehen.md)
Verdampfen=[Verdampfen](zauber/verdampfen.md)
Vergrössern=[Vergrössern](zauber/vergroessern.md)
Vergrößern=[Vergrößern](zauber/vergroessern.md)
Verkleinern=[Verkleinern](zauber/verkleinern.md)
Verlangsamen=[Verlangsamen](zauber/verlangsamen.md)
Versetzen=[Versetzen](zauber/versetzen.md)
Versetzte Stimme=[Versetzte Stimme](zauber/versetzte-stimme.md)
Verteidigung=[Verteidigung](zauber/verteidigung.md)
Vertreiben=[Vertreiben](zauber/vertreiben.md)
Verwandlung=[Verwandlung](zauber/verwandlung.md)
Verwirren=[Verwirren](zauber/verwirren.md)
Volksgestalt=[Volksgestalt](zauber/volksgestalt.md)
Wächter=[Wächter](zauber/waechter.md)
Waffe des Lichts=[Waffe des Lichts](zauber/waffe-des-lichts.md)
Wahnsinn=[Wahnsinn](zauber/wahnsinn.md)
Wandöffnung=[Wandöffnung](zauber/wandoeffnung.md)
Wasser teilen=[Wasser teilen](zauber/wasser-teilen.md)
Wasserwandeln=[Wasserwandeln](zauber/wasserwandeln.md)
Wasser weihen=[Wasser weihen](zauber/wasser-weihen.md)
Wechselzauber=[Wechselzauber](zauber/wechselzauber.md)
Wiederbelebung=[Wiederbelebung](zauber/wiederbelebung.md)
Wolke der Reue=[Wolke der Reue](zauber/wolke-der-reue.md)
Wolke des Todes=[Wolke des Todes](zauber/wolke-des-todes.md)
Zauberabklang=[Zauberabklang](zauber/zauberabklang.md)
Zauber auslösen=[Zauber auslösen](talente/zauber-ausloesen.md)
Zauberer=[Zauberer](charaktere-klasse-zauberer.md)
Zauberleiter=[Zauberleiter](zauber/zauberleiter.md)
Zaubermacht=[Zaubermacht](talente/zaubermacht.md)
Zauberqual=[Zauberqual](talente/zauberqual.md)
Zauberroutine=[Zauberroutine](talente/zauberroutine.md)
Zaubersprüche=[Zaubersprüche](zaubersprueche.md)
Zaubertrick=[Zaubertrick](zauber/zaubertrick.md)
Zauberwaffe=[Zauberwaffe](talente/zauberwaffe.md)
Zeitstop=[Zeitstop](zauber/zeitstop.md)
Zombies erwecken=[Zombies erwecken](zauber/zombies-erwecken.md)
Attentäter=[Attentäter](charaktere-heldenklassen-attentaeter.md)
Berserker=[Berserker](charaktere-heldenklassen-berserker.md)
Blutmagier=[Blutmagier](charaktere-heldenklassen-blutmagier.md)
Dämonologe=[Dämonologe](charaktere-heldenklassen-daemonologe.md)
Druide=[Druide](charaktere-heldenklassen-druide.md)
Elementarist=[Elementarist](charaktere-heldenklassen-elementarist.md)
Erzmagier=[Erzmagier](charaktere-heldenklassen-erzmagier.md)
Heiler=[Heiler](charaktere-klasse-heiler.md)
Heldenklassen=[Heldenklassen](charaktere-heldenklassen.md)
Kampfmönch=[Kampfmönch](charaktere-heldenklassen-kampfmoench.md)
Kleriker=[Kleriker](charaktere-heldenklassen-kleriker.md)
Krieger=[Krieger](charaktere-klasse-krieger.md)
Kriegszauberer=[Kriegszauberer](charaktere-heldenklassen-kriegszauberer.md)
Meisterdieb=[Meisterdieb](charaktere-heldenklassen-meisterdieb.md)
Nekromant=[Nekromant](charaktere-heldenklassen-nekromant.md)
Paladin=[Paladin](charaktere-heldenklassen-paladin.md)
Schwarzmagier=[Schwarzmagier](charaktere-klasse-schwarzmagier.md)
Späher=[Späher](charaktere-klasse-spaeher.md)
Waffenmeister=[Waffenmeister](charaktere-heldenklassen-waffenmeister.md)
Waldläufer=[Waldläufer](charaktere-heldenklassen-waldlaeufer.md)
Zauberer=[Zauberer](charaktere-klasse-zauberer.md)
Zauberwirker=[Zauberwirker](charaktere-klasse-zauberwirker.md)