Aberglaube=[Aberglaube](fanwerk/talente/aberglaube.md)
Ablenkender Schuss=[Ablenkender Schuss](fanwerk/talente/ablenkender-schuss.md)
Ablenken=[Ablenken](fanwerk/zauber/ablenken.md)
Achtloser Vorstoss=[Achtloser Vorstoss](fanwerk/talente/achtloser-vorstoss.md)
Aderplatzer=[Aderplatzer](fanwerk/zauber/aderplatzer.md)
Aensteiner Soldat=[Aensteiner Soldat](fanwerk/bestiarium/aensteiner-soldat.md)
Aensteiner Wilderer=[Aensteiner Wilderer](fanwerk/bestiarium/aensteiner-wilderer.md)
Airigh=[Airigh](fanwerk/bestiarium/airigh.md)
Akyna=[Akyna](fanwerk/bestiarium/akyna.md)
Allerweltsgesicht=[Allerweltsgesicht](fanwerk/talente/allerweltsgesicht.md)
Alle Zauber aufheben=[Alle Zauber aufheben](fanwerk/zauber/alle-zauber-aufheben.md)
Al-Nuzzran=[Al-Nuzzran](fanwerk/bestiarium/al-nuzzran.md)
Altern=[Altern](fanwerk/zauber/altern.md)
Amok=[Amok](fanwerk/zauber/amok.md)
Anarioth 'Der Sturmrufer'=[Anarioth 'Der Sturmrufer'](fanwerk/bestiarium/anarioth-der-sturmrufer.md)
Angischer Clanskrieger=[Angischer Clanskrieger](fanwerk/bestiarium/angischer-clanskrieger.md)
Anknurren=[Anknurren](fanwerk/talente/anknurren.md)
Anlocken=[Anlocken](fanwerk/zauber/anlocken.md)
Anpassung=[Anpassung](fanwerk/zauber/anpassung.md)
Antimagie=[Antimagie](fanwerk/zauber/antimagie.md)
Apokalpytischer Reiter der Pestilenz=[Apokalpytischer Reiter der Pestilenz](fanwerk/bestiarium/apokalpytischer-reiter-der-pestilenz.md)
Apokalpytischer Reiter des Hungers=[Apokalpytischer Reiter des Hungers](fanwerk/bestiarium/apokalpytischer-reiter-des-hungers.md)
Apokalpytischer Reiter des Kriegs=[Apokalpytischer Reiter des Kriegs](fanwerk/bestiarium/apokalpytischer-reiter-des-kriegs.md)
Apokalpytischer Reiter des Todes=[Apokalpytischer Reiter des Todes](fanwerk/bestiarium/apokalpytischer-reiter-des-todes.md)
Apokalpytisches Ross=[Apokalpytisches Ross](fanwerk/bestiarium/apokalpytisches-ross.md)
Arbeiter=[Arbeiter](fanwerk/bestiarium/arbeiter.md)
Archivar=[Archivar](fanwerk/talente/archivar.md)
Arcuna=[Arcuna](fanwerk/bestiarium/arcuna.md)
Arkane Aufladung=[Arkane Aufladung](fanwerk/zauber/arkane-aufladung.md)
Arkane Faust=[Arkane Faust](fanwerk/zauber/arkane-faust.md)
Arkane Klaue=[Arkane Klaue](fanwerk/zauber/arkane-klaue.md)
Arkaner Stiefel=[Arkaner Stiefel](fanwerk/zauber/arkaner-stiefel.md)
Arken Beijl=[Arken Beijl](fanwerk/bestiarium/arken-beijl.md)
Ascheelf Krieger=[Ascheelf Krieger](fanwerk/bestiarium/ascheelf-krieger.md)
Ascheelf Rächer=[Ascheelf Rächer](fanwerk/bestiarium/ascheelf-raecher.md)
Ascheelf Späher=[Ascheelf Späher](fanwerk/bestiarium/ascheelf-spaeher.md)
Asphyx=[Asphyx](fanwerk/bestiarium/asphyx.md)
Atemfrei=[Atemfrei](fanwerk/zauber/atemfrei.md)
Auferstehung=[Auferstehung](fanwerk/zauber/auferstehung.md)
Auf Ex!=[Auf Ex!](fanwerk/talente/auf-ex.md)
Augenwand=[Augenwand](fanwerk/zauber/augenwand.md)
Aura der Vergeltung=[Aura der Vergeltung](fanwerk/zauber/aura-der-vergeltung.md)
Aura des Mutes=[Aura des Mutes](fanwerk/talente/aura-des-mutes.md)
Ausbrennen=[Ausbrennen](fanwerk/talente/ausbrennen.md)
Aus dem Ärmel=[Aus dem Ärmel](fanwerk/talente/aus-dem-aermel.md)
Aus den Beinen!=[Aus den Beinen!](fanwerk/talente/aus-den-beinen.md)
Autorität=[Autorität](fanwerk/talente/autoritaet.md)
Baby Monsterspinne=[Baby Monsterspinne](fanwerk/bestiarium/baby-monsterspinne.md)
Ballistischer Flug=[Ballistischer Flug](fanwerk/zauber/ballistischer-flug.md)
Bannsphäre=[Bannsphäre](fanwerk/zauber/bannsphaere.md)
Bardenlieder=[Bardenlieder](fanwerk/talente/bardenlieder.md)
Barex=[Barex](fanwerk/bestiarium/barex.md)
Baumgolem=[Baumgolem](fanwerk/bestiarium/baumgolem.md)
Befreiender Schmerz=[Befreiender Schmerz](fanwerk/talente/befreiender-schmerz.md)
Beinfeger=[Beinfeger](fanwerk/talente/beinfeger.md)
Belebtes Trugbild=[Belebtes Trugbild](fanwerk/talente/belebtes-trugbild.md)
Belgor=[Belgor](fanwerk/bestiarium/belgor.md)
Bergzwergischer Söldner=[Bergzwergischer Söldner](fanwerk/bestiarium/bergzwergischer-soeldner.md)
Berna-Priesterin=[Berna-Priesterin](fanwerk/bestiarium/berna-priesterin.md)
Beschwörer peinigen=[Beschwörer peinigen](fanwerk/talente/beschwoerer-peinigen.md)
Besessenheit 1=[Besessenheit 1](fanwerk/zauber/besessenheit-1.md)
Besessenheit 2=[Besessenheit 2](fanwerk/zauber/besessenheit-2.md)
Beulenpest=[Beulenpest](fanwerk/zauber/beulenpest.md)
Billiger Söldner=[Billiger Söldner](fanwerk/bestiarium/billiger-soeldner.md)
Blasaminator=[Blasaminator](fanwerk/bestiarium/blasaminator.md)
Blind kämpfen=[Blind kämpfen](fanwerk/talente/blind-kaempfen.md)
Blitzschild=[Blitzschild](fanwerk/zauber/blitzschild.md)
Blob=[Blob](fanwerk/bestiarium/blob.md)
Blutband=[Blutband](fanwerk/talente/blutband.md)
Blutentzug=[Blutentzug](fanwerk/zauber/blutentzug.md)
Blutige Berührung=[Blutige Berührung](fanwerk/zauber/blutige-beruehrung.md)
Blutige Vergeltung=[Blutige Vergeltung](fanwerk/talente/blutige-vergeltung.md)
Blutmaske=[Blutmaske](fanwerk/talente/blutmaske.md)
Blutnebel=[Blutnebel](fanwerk/zauber/blutnebel.md)
Blutrache=[Blutrache](fanwerk/talente/blutrache.md)
Blutraub=[Blutraub](fanwerk/zauber/blutraub.md)
Blutschmied=[Blutschmied](fanwerk/talente/blutschmied.md)
Blut-Zaubertrank=[Blut-Zaubertrank](fanwerk/talente/blut-zaubertrank.md)
Bodenkampf=[Bodenkampf](fanwerk/talente/bodenkampf.md)
Bodenstacheln=[Bodenstacheln](fanwerk/zauber/bodenstacheln.md)
Bosker Sturmkrähe (Söldner)=[Bosker Sturmkrähe (Söldner)](fanwerk/bestiarium/bosker-sturmkraehe-soeldner.md)
Botenteufel=[Botenteufel](fanwerk/zauber/botenteufel.md)
Brambel=[Brambel](fanwerk/bestiarium/brambel.md)
Brasko=[Brasko](fanwerk/bestiarium/brasko.md)
Brimborium=[Brimborium](fanwerk/zauber/brimborium.md)
Brutac=[Brutac](fanwerk/bestiarium/brutac.md)
Brutbauch=[Brutbauch](fanwerk/talente/brutbauch.md)
Bulegor=[Bulegor](fanwerk/bestiarium/bulegor.md)
Caerner Freibeuter=[Caerner Freibeuter](fanwerk/bestiarium/caerner-freibeuter.md)
Casius=[Casius](fanwerk/bestiarium/casius.md)
Chalog Omesch=[Chalog Omesch](fanwerk/bestiarium/chalog-omesch.md)
Chaoszauber=[Chaoszauber](fanwerk/zauber/chaoszauber.md)
Chi-Blockade=[Chi-Blockade](fanwerk/talente/chi-blockade.md)
Chien Kwan=[Chien Kwan](fanwerk/bestiarium/chien-kwan.md)
Chio-Puan Wandermönch=[Chio-Puan Wandermönch](fanwerk/bestiarium/chio-puan-wandermoench.md)
Copperntaler Milizionär=[Copperntaler Milizionär](fanwerk/bestiarium/copperntaler-milizionaer.md)
Cranag der Wanderer=[Cranag der Wanderer](fanwerk/bestiarium/cranag-der-wanderer.md)
Dämonengestalt=[Dämonengestalt](fanwerk/talente/daemonengestalt.md)
Dämonenschwingen=[Dämonenschwingen](fanwerk/talente/daemonenschwingen.md)
Dampfkutsche=[Dampfkutsche](fanwerk/bestiarium/dampfkutsche.md)
De-Evolution=[De-Evolution](fanwerk/zauber/de-evolution.md)
Deformierter Drachenwelpe=[Deformierter Drachenwelpe](fanwerk/bestiarium/deformierter-drachenwelpe.md)
Der Ketzer=[Der Ketzer](fanwerk/bestiarium/der-ketzer.md)
Dermot Madal=[Dermot Madal](fanwerk/bestiarium/dermot-madal.md)
Der Weltenfresser=[Der Weltenfresser](fanwerk/bestiarium/der-weltenfresser.md)
Die Eiskönigin=[Die Eiskönigin](fanwerk/bestiarium/die-eiskoenigin.md)
Dimensionssprung=[Dimensionssprung](fanwerk/talente/dimensionssprung.md)
Dirion=[Dirion](fanwerk/bestiarium/dirion.md)
Donnerechse=[Donnerechse](fanwerk/bestiarium/donnerechse.md)
Donnervogel=[Donnervogel](fanwerk/bestiarium/donnervogel.md)
Doppelgänger 1=[Doppelgänger 1](fanwerk/zauber/doppelgaenger-1.md)
Doppelgänger 2=[Doppelgänger 2](fanwerk/zauber/doppelgaenger-2.md)
Doppelschlag=[Doppelschlag](fanwerk/talente/doppelschlag.md)
Dornenwuchs=[Dornenwuchs](fanwerk/zauber/dornenwuchs.md)
Drac=[Drac](fanwerk/bestiarium/drac.md)
Drachentöter=[Drachentöter](fanwerk/talente/drachentoeter.md)
Drazuul die Verderberin=[Drazuul die Verderberin](fanwerk/bestiarium/drazuul-die-verderberin.md)
Druckverband=[Druckverband](fanwerk/talente/druckverband.md)
Druckwelle=[Druckwelle](fanwerk/talente/druckwelle.md)
Duldgnomischer Zaubertechniker=[Duldgnomischer Zaubertechniker](fanwerk/bestiarium/duldgnomischer-zaubertechniker.md)
Dunkelheit spüren=[Dunkelheit spüren](fanwerk/zauber/dunkelheit-spueren.md)
Dunkler Krieger=[Dunkler Krieger](fanwerk/bestiarium/dunkler-krieger.md)
Dunkle Segnung=[Dunkle Segnung](fanwerk/zauber/dunkle-segnung.md)
Durchschuss=[Durchschuss](fanwerk/talente/durchschuss.md)
Ebene erschaffen=[Ebene erschaffen](fanwerk/zauber/ebene-erschaffen.md)
Ebenensprung=[Ebenensprung](fanwerk/zauber/ebenensprung.md)
Edelsteinbombe=[Edelsteinbombe](fanwerk/zauber/edelsteinbombe.md)
Edelsteinfalle=[Edelsteinfalle](fanwerk/zauber/edelsteinfalle.md)
Ehrenduell=[Ehrenduell](fanwerk/talente/ehrenduell.md)
Eifriger Slayer=[Eifriger Slayer](fanwerk/talente/eifriger-slayer.md)
Eigenschaften erkennen=[Eigenschaften erkennen](fanwerk/zauber/eigenschaften-erkennen.md)
Eigenschaft erhöhen=[Eigenschaft erhöhen](fanwerk/zauber/eigenschaft-erhoehen.md)
Eigenschaft stärken=[Eigenschaft stärken](fanwerk/zauber/eigenschaft-staerken.md)
Eigenschaft verbessern=[Eigenschaft verbessern](fanwerk/zauber/eigenschaft-verbessern.md)
Einbrecher=[Einbrecher](fanwerk/bestiarium/einbrecher.md)
Eiselementar III=[Eiselementar III](fanwerk/bestiarium/eiselementar-iii.md)
Eisengestalt=[Eisengestalt](fanwerk/zauber/eisengestalt.md)
Eisenhaller Armbrustschütze=[Eisenhaller Armbrustschütze](fanwerk/bestiarium/eisenhaller-armbrustschuetze.md)
Eiswand=[Eiswand](fanwerk/zauber/eiswand.md)
Eiswolf=[Eiswolf](fanwerk/bestiarium/eiswolf.md)
Eiszwerg=[Eiszwerg](fanwerk/bestiarium/eiszwerg.md)
Eldvyn=[Eldvyn](fanwerk/bestiarium/eldvyn.md)
Eleganter Stich=[Eleganter Stich](fanwerk/talente/eleganter-stich.md)
Elementare Energie=[Elementare Energie](fanwerk/talente/elementare-energie.md)
Elementare Explosion=[Elementare Explosion](fanwerk/talente/elementare-explosion.md)
Elementarer Waffenmeister=[Elementarer Waffenmeister](fanwerk/talente/elementarer-waffenmeister.md)
Elementargestalt=[Elementargestalt](fanwerk/talente/elementargestalt.md)
Elementarschutz=[Elementarschutz](fanwerk/zauber/elementarschutz.md)
Elementarsinn=[Elementarsinn](fanwerk/zauber/elementarsinn.md)
Engel der Apokalypse=[Engel der Apokalypse](fanwerk/bestiarium/engel-der-apokalypse.md)
Engelsschwingen=[Engelsschwingen](fanwerk/talente/engelsschwingen.md)
Entfesseln=[Entfesseln](fanwerk/zauber/entfesseln.md)
Enthüllende Aura=[Enthüllende Aura](fanwerk/zauber/enthuellende-aura.md)
Entkörpern=[Entkörpern](fanwerk/zauber/entkoerpern.md)
Entsteinern=[Entsteinern](fanwerk/zauber/entsteinern.md)
Entwaffnen=[Entwaffnen](fanwerk/talente/entwaffnen.md)
Entweihen=[Entweihen](fanwerk/zauber/entweihen.md)
Entzaubern=[Entzaubern](fanwerk/zauber/entzaubern.md)
Enural=[Enural](fanwerk/bestiarium/enural.md)
Erald=[Erald](fanwerk/bestiarium/erald.md)
Erfahrener Rattling=[Erfahrener Rattling](fanwerk/bestiarium/erfahrener-rattling.md)
Erholsames Nickerchen=[Erholsames Nickerchen](fanwerk/zauber/erholsames-nickerchen.md)
Erindor=[Erindor](fanwerk/bestiarium/erindor.md)
Erschütternder Schlag=[Erschütternder Schlag](fanwerk/talente/erschuetternder-schlag.md)
Erzfeind=[Erzfeind](fanwerk/talente/erzfeind.md)
Erzwungenes Vergrössern=[Erzwungenes Vergrössern](fanwerk/zauber/erzwungenes-vergroessern.md)
Erzwungenes Verkleinern=[Erzwungenes Verkleinern](fanwerk/zauber/erzwungenes-verkleinern.md)
Erzwungenes Versetzen=[Erzwungenes Versetzen](fanwerk/zauber/erzwungenes-versetzen.md)
Ettin=[Ettin](fanwerk/bestiarium/ettin.md)
Explosiver Teleport=[Explosiver Teleport](fanwerk/zauber/explosiver-teleport.md)
Fähigkeiten erkennen=[Fähigkeiten erkennen](fanwerk/zauber/faehigkeiten-erkennen.md)
Fahlstepper Grenzwächter=[Fahlstepper Grenzwächter](fanwerk/bestiarium/fahlstepper-grenzwaechter.md)
Falsche Magie=[Falsche Magie](fanwerk/zauber/falsche-magie.md)
Falschspieler=[Falschspieler](fanwerk/bestiarium/falschspieler.md)
Faria (Feuermagierin)=[Faria (Feuermagierin)](fanwerk/bestiarium/faria-feuermagierin.md)
Fata Morgana=[Fata Morgana](fanwerk/zauber/fata-morgana.md)
Faulbauchmaden erwecken=[Faulbauchmaden erwecken](fanwerk/zauber/faulbauchmaden-erwecken.md)
Faustkämpfer=[Faustkämpfer](fanwerk/talente/faustkaempfer.md)
Feenblütig=[Feenblütig](fanwerk/talente/feenbluetig.md)
Feiner Geruchssinn=[Feiner Geruchssinn](fanwerk/talente/feiner-geruchssinn.md)
Feldsegen=[Feldsegen](fanwerk/zauber/feldsegen.md)
Fenya=[Fenya](fanwerk/bestiarium/fenya.md)
Fesselnde Persönlichkeit=[Fesselnde Persönlichkeit](fanwerk/talente/fesselnde-persoenlichkeit.md)
Fetter Goblin-Aufseher=[Fetter Goblin-Aufseher](fanwerk/bestiarium/fetter-goblin-aufseher.md)
Feuer löschen=[Feuer löschen](fanwerk/zauber/feuer-loeschen.md)
Feuerschutz=[Feuerschutz](fanwerk/zauber/feuerschutz.md)
Fjordinger Wikinger=[Fjordinger Wikinger](fanwerk/bestiarium/fjordinger-wikinger.md)
Fjordorzwergischer Kaperfahrer=[Fjordorzwergischer Kaperfahrer](fanwerk/bestiarium/fjordorzwergischer-kaperfahrer.md)
Flammenaura=[Flammenaura](fanwerk/zauber/flammenaura.md)
Flammensphären=[Flammensphären](fanwerk/zauber/flammensphaeren.md)
Flankierer=[Flankierer](fanwerk/talente/flankierer.md)
Fliegender Schädel=[Fliegender Schädel](fanwerk/bestiarium/fliegender-schaedel.md)
Floragon=[Floragon](fanwerk/bestiarium/floragon.md)
Freiländer Dämonenjäger=[Freiländer Dämonenjäger](fanwerk/bestiarium/freilaender-daemonenjaeger.md)
Freizauber=[Freizauber](fanwerk/zauber/freizauber.md)
Fresssack=[Fresssack](fanwerk/talente/fresssack.md)
Fronarbeit=[Fronarbeit](fanwerk/talente/fronarbeit.md)
Früheres Leben=[Früheres Leben](fanwerk/talente/frueheres-leben.md)
Funkenfieper=[Funkenfieper](fanwerk/bestiarium/funkenfieper.md)
Furcht bannen=[Furcht bannen](fanwerk/zauber/furcht-bannen.md)
Galen=[Galen](fanwerk/bestiarium/galen.md)
Gärtner=[Gärtner](fanwerk/bestiarium/gaertner.md)
Gaukelei=[Gaukelei](fanwerk/zauber/gaukelei.md)
Geborenes Genie=[Geborenes Genie](fanwerk/talente/geborenes-genie.md)
Gedächtnislöschung=[Gedächtnislöschung](fanwerk/zauber/gedaechtnisloeschung.md)
Gedankenleere=[Gedankenleere](fanwerk/zauber/gedankenleere.md)
Gedanken lesen=[Gedanken lesen](fanwerk/zauber/gedanken-lesen.md)
Gedankenzehrerstrahl=[Gedankenzehrerstrahl](fanwerk/zauber/gedankenzehrerstrahl.md)
Gefahrensinn=[Gefahrensinn](fanwerk/zauber/gefahrensinn.md)
Gegenhalten=[Gegenhalten](fanwerk/talente/gegenhalten.md)
Gegenstand benutzen=[Gegenstand benutzen](fanwerk/talente/gegenstand-benutzen.md)
Gegenstand entdecken=[Gegenstand entdecken](fanwerk/zauber/gegenstand-entdecken.md)
Gegner fernhalten=[Gegner fernhalten](fanwerk/zauber/gegner-fernhalten.md)
Geheimtür=[Geheimtür](fanwerk/zauber/geheimtuer.md)
Geistergestalt=[Geistergestalt](fanwerk/talente/geistergestalt.md)
Geisterklinge=[Geisterklinge](fanwerk/zauber/geisterklinge.md)
Geisterlanze=[Geisterlanze](fanwerk/zauber/geisterlanze.md)
Geisterpfeil=[Geisterpfeil](fanwerk/zauber/geisterpfeil.md)
Geistheiler=[Geistheiler](fanwerk/talente/geistheiler.md)
Geistige Verbindung=[Geistige Verbindung](fanwerk/zauber/geistige-verbindung.md)
Geist leeren=[Geist leeren](fanwerk/zauber/geist-leeren.md)
Geistpeiniger=[Geistpeiniger](fanwerk/bestiarium/geistpeiniger.md)
Geist verleihen=[Geist verleihen](fanwerk/talente/geist-verleihen.md)
Gerinnsel=[Gerinnsel](fanwerk/zauber/gerinnsel.md)
Geschosse abwehren=[Geschosse abwehren](fanwerk/talente/geschosse-abwehren.md)
Gestalt verändern=[Gestalt verändern](fanwerk/zauber/gestalt-veraendern.md)
Gestaltwandeln=[Gestaltwandeln](fanwerk/zauber/gestaltwandeln.md)
Gestrüpp=[Gestrüpp](fanwerk/zauber/gestruepp.md)
Geteiltes Leben=[Geteiltes Leben](fanwerk/zauber/geteiltes-leben.md)
Getreuer Dammenhalls=[Getreuer Dammenhalls](fanwerk/bestiarium/getreuer-dammenhalls.md)
Geysir=[Geysir](fanwerk/zauber/geysir.md)
Giftexplosion=[Giftexplosion](fanwerk/talente/giftexplosion.md)
Giftgasgestalt=[Giftgasgestalt](fanwerk/zauber/giftgasgestalt.md)
Giftiges Blut=[Giftiges Blut](fanwerk/talente/giftiges-blut.md)
Giftklinge=[Giftklinge](fanwerk/zauber/giftklinge.md)
Giftlanze=[Giftlanze](fanwerk/zauber/giftlanze.md)
Giftstrahl=[Giftstrahl](fanwerk/zauber/giftstrahl.md)
Gift verstärken=[Gift verstärken](fanwerk/zauber/gift-verstaerken.md)
Gisamor=[Gisamor](fanwerk/bestiarium/gisamor.md)
Glänzendes Vorbild=[Glänzendes Vorbild](fanwerk/talente/glaenzendes-vorbild.md)
Glaube mir=[Glaube mir](fanwerk/zauber/glaube-mir.md)
Glitzerhand (Dieb)=[Glitzerhand (Dieb)](fanwerk/bestiarium/glitzerhand-dieb.md)
Gloriel 'Die Kräuterhexe'=[Gloriel 'Die Kräuterhexe'](fanwerk/bestiarium/gloriel-die-kraeuterhexe.md)
Glücksklinge=[Glücksklinge](fanwerk/zauber/gluecksklinge.md)
Glücksschild=[Glücksschild](fanwerk/zauber/gluecksschild.md)
Gnädiger Zauberer=[Gnädiger Zauberer](fanwerk/talente/gnaediger-zauberer.md)
Gnomischer Illusionist=[Gnomischer Illusionist](fanwerk/bestiarium/gnomischer-illusionist.md)
Goblin Berserker=[Goblin Berserker](fanwerk/bestiarium/goblin-berserker.md)
Goblin Bomber=[Goblin Bomber](fanwerk/bestiarium/goblin-bomber.md)
Goblin Giftmörder=[Goblin Giftmörder](fanwerk/bestiarium/goblin-giftmoerder.md)
Goblin Häuptling=[Goblin Häuptling](fanwerk/bestiarium/goblin-haeuptling.md)
Goblin Krieger=[Goblin Krieger](fanwerk/bestiarium/goblin-krieger.md)
Goblinrächer=[Goblinrächer](fanwerk/bestiarium/goblinraecher.md)
Goblin Schamane=[Goblin Schamane](fanwerk/bestiarium/goblin-schamane.md)
Goblin Späher=[Goblin Späher](fanwerk/bestiarium/goblin-spaeher.md)
Goblin Stadtratte=[Goblin Stadtratte](fanwerk/bestiarium/goblin-stadtratte.md)
Golemarmee=[Golemarmee](fanwerk/talente/golemarmee.md)
Golem erwecken=[Golem erwecken](fanwerk/zauber/golem-erwecken.md)
Golem zerschmettern=[Golem zerschmettern](fanwerk/talente/golem-zerschmettern.md)
Gralbor Weißauge=[Gralbor Weißauge](fanwerk/bestiarium/gralbor-weiauge.md)
Granaten erschaffen=[Granaten erschaffen](fanwerk/zauber/granaten-erschaffen.md)
Grosses Ablenken=[Grosses Ablenken](fanwerk/zauber/grosses-ablenken.md)
Grosses Schwächen=[Grosses Schwächen](fanwerk/zauber/grosses-schwaechen.md)
Grosses Stören=[Grosses Stören](fanwerk/zauber/grosses-stoeren.md)
Grosse Unsichtbarkeit=[Grosse Unsichtbarkeit](fanwerk/zauber/grosse-unsichtbarkeit.md)
Großmutter Gorla=[Großmutter Gorla](fanwerk/bestiarium/gromutter-gorla.md)
Grottenschrat=[Grottenschrat](fanwerk/bestiarium/grottenschrat.md)
Grube=[Grube](fanwerk/zauber/grube.md)
Grufthauptmann=[Grufthauptmann](fanwerk/bestiarium/grufthauptmann.md)
Gruftplünderer=[Gruftplünderer](fanwerk/bestiarium/gruftpluenderer.md)
Gruftritter=[Gruftritter](fanwerk/bestiarium/gruftritter.md)
Halblingskelett=[Halblingskelett](fanwerk/bestiarium/halblingskelett.md)
Halluzination=[Halluzination](fanwerk/talente/halluzination.md)
Harpunieren=[Harpunieren](fanwerk/zauber/harpunieren.md)
Hartmund=[Hartmund](fanwerk/bestiarium/hartmund.md)
Hast=[Hast](fanwerk/zauber/hast.md)
Hau Ruck!=[Hau Ruck!](fanwerk/talente/hau-ruck.md)
Häuten=[Häuten](fanwerk/zauber/haeuten.md)
Heftiger Ansturm=[Heftiger Ansturm](fanwerk/talente/heftiger-ansturm.md)
Heilende Rune=[Heilende Rune](fanwerk/zauber/heilende-rune.md)
Heilendes Gift=[Heilendes Gift](fanwerk/zauber/heilendes-gift.md)
Heilende Sphäre=[Heilende Sphäre](fanwerk/zauber/heilende-sphaere.md)
Heiler (Schütze 01)=[Heiler (Schütze 01)](fanwerk/bestiarium/heiler-schuetze-01.md)
Heiler (Schütze 04)=[Heiler (Schütze 04)](fanwerk/bestiarium/heiler-schuetze-04.md)
Heiler (Schütze 08)=[Heiler (Schütze 08)](fanwerk/bestiarium/heiler-schuetze-08.md)
Heiler (Schütze 12)=[Heiler (Schütze 12)](fanwerk/bestiarium/heiler-schuetze-12.md)
Heiligtum=[Heiligtum](fanwerk/zauber/heiligtum.md)
Heiltrank verderben=[Heiltrank verderben](fanwerk/zauber/heiltrank-verderben.md)
Heilungsraub=[Heilungsraub](fanwerk/zauber/heilungsraub.md)
Heilung stoppen=[Heilung stoppen](fanwerk/zauber/heilung-stoppen.md)
Heilung verhindern=[Heilung verhindern](fanwerk/zauber/heilung-verhindern.md)
Heimsucher=[Heimsucher](fanwerk/bestiarium/heimsucher.md)
Heimvorteil=[Heimvorteil](fanwerk/zauber/heimvorteil.md)
Heldentum=[Heldentum](fanwerk/zauber/heldentum.md)
Hellweiter Diplomat=[Hellweiter Diplomat](fanwerk/bestiarium/hellweiter-diplomat.md)
Heob (Ordensheiler)=[Heob (Ordensheiler)](fanwerk/bestiarium/heob-ordensheiler.md)
Heranziehen=[Heranziehen](fanwerk/zauber/heranziehen.md)
Herr des Waldes=[Herr des Waldes](fanwerk/talente/herr-des-waldes.md)
Hiergeblieben=[Hiergeblieben](fanwerk/zauber/hiergeblieben.md)
Hilaner Priester=[Hilaner Priester](fanwerk/bestiarium/hilaner-priester.md)
Hilanischer Peltast=[Hilanischer Peltast](fanwerk/bestiarium/hilanischer-peltast.md)
Himmelswächter=[Himmelswächter](fanwerk/talente/himmelswaechter.md)
Höheren Dämon rufen=[Höheren Dämon rufen](fanwerk/zauber/hoeheren-daemon-rufen.md)
Höllenhund rufen=[Höllenhund rufen](fanwerk/zauber/hoellenhund-rufen.md)
Holzfäule=[Holzfäule](fanwerk/zauber/holzfaeule.md)
Holz formen=[Holz formen](fanwerk/zauber/holz-formen.md)
Hungriger Schatten=[Hungriger Schatten](fanwerk/zauber/hungriger-schatten.md)
Identifizierer=[Identifizierer](fanwerk/talente/identifizierer.md)
Iglorion=[Iglorion](fanwerk/bestiarium/iglorion.md)
Illusionswand=[Illusionswand](fanwerk/zauber/illusionswand.md)
In die Kerbe!=[In die Kerbe!](fanwerk/talente/in-die-kerbe.md)
Infernale Bindung=[Infernale Bindung](fanwerk/talente/infernale-bindung.md)
Inneres Chi=[Inneres Chi](fanwerk/talente/inneres-chi.md)
Inquisition=[Inquisition](fanwerk/zauber/inquisition.md)
Insektentöter=[Insektentöter](fanwerk/talente/insektentoeter.md)
Instrumentbindung=[Instrumentbindung](fanwerk/talente/instrumentbindung.md)
Irrlicht=[Irrlicht](fanwerk/bestiarium/irrlicht.md)
Jödländer Schamanin=[Jödländer Schamanin](fanwerk/bestiarium/joedlaender-schamanin.md)
Jok von Walderson=[Jok von Walderson](fanwerk/bestiarium/jok-von-walderson.md)
Josip=[Josip](fanwerk/bestiarium/josip.md)
Jost Rotweiden=[Jost Rotweiden](fanwerk/bestiarium/jost-rotweiden.md)
Kadaverexplosion=[Kadaverexplosion](fanwerk/zauber/kadaverexplosion.md)
Kaholwächter=[Kaholwächter](fanwerk/bestiarium/kaholwaechter.md)
Kait Jadedrache=[Kait Jadedrache](fanwerk/bestiarium/kait-jadedrache.md)
Kait Ninja=[Kait Ninja](fanwerk/bestiarium/kait-ninja.md)
Kait Schwertgelehrter=[Kait Schwertgelehrter](fanwerk/bestiarium/kait-schwertgelehrter.md)
Kampfdämon rufen=[Kampfdämon rufen](fanwerk/zauber/kampfdaemon-rufen.md)
Kampfgefährte=[Kampfgefährte](fanwerk/talente/kampfgefaehrte.md)
Kampfmagier 01=[Kampfmagier 01](fanwerk/bestiarium/kampfmagier-01.md)
Kampfmagier 04=[Kampfmagier 04](fanwerk/bestiarium/kampfmagier-04.md)
Kampfmagier 08=[Kampfmagier 08](fanwerk/bestiarium/kampfmagier-08.md)
Kampfmagier 12=[Kampfmagier 12](fanwerk/bestiarium/kampfmagier-12.md)
Kauderwelsch=[Kauderwelsch](fanwerk/zauber/kauderwelsch.md)
Kavija die Uralte=[Kavija die Uralte](fanwerk/bestiarium/kavija-die-uralte.md)
Kerberos=[Kerberos](fanwerk/bestiarium/kerberos.md)
Kiai=[Kiai](fanwerk/talente/kiai.md)
Ki-Schlag=[Ki-Schlag](fanwerk/talente/ki-schlag.md)
Klangexplosion=[Klangexplosion](fanwerk/talente/klangexplosion.md)
Klauen der Verdammnis=[Klauen der Verdammnis](fanwerk/talente/klauen-der-verdammnis.md)
Klauenhände=[Klauenhände](fanwerk/zauber/klauenhaende.md)
Klebefaden=[Klebefaden](fanwerk/zauber/klebefaden.md)
Kleine Mordmücke=[Kleine Mordmücke](fanwerk/bestiarium/kleine-mordmuecke.md)
Kleiner Augenball=[Kleiner Augenball](fanwerk/bestiarium/kleiner-augenball.md)
Kleiner Borstenwurm=[Kleiner Borstenwurm](fanwerk/bestiarium/kleiner-borstenwurm.md)
Kleiner Knochengolem=[Kleiner Knochengolem](fanwerk/bestiarium/kleiner-knochengolem.md)
Kleine Unsichtbarkeit=[Kleine Unsichtbarkeit](fanwerk/zauber/kleine-unsichtbarkeit.md)
Klettern=[Klettern](fanwerk/zauber/klettern.md)
Klingenwand=[Klingenwand](fanwerk/zauber/klingenwand.md)
Knochenbrecher=[Knochenbrecher](fanwerk/talente/knochenbrecher.md)
Komplize=[Komplize](fanwerk/bestiarium/komplize.md)
Konstrukt kapern=[Konstrukt kapern](fanwerk/zauber/konstrukt-kapern.md)
Koordination=[Koordination](fanwerk/talente/koordination.md)
Kopieren=[Kopieren](fanwerk/zauber/kopieren.md)
Kral der Schreckliche=[Kral der Schreckliche](fanwerk/bestiarium/kral-der-schreckliche.md)
Krallenfinger=[Krallenfinger](fanwerk/talente/krallenfinger.md)
Kräuterexperte=[Kräuterexperte](fanwerk/talente/kraeuterexperte.md)
Kräuterkundiger=[Kräuterkundiger](fanwerk/talente/kraeuterkundiger.md)
Kriegsdämon rufen=[Kriegsdämon rufen](fanwerk/zauber/kriegsdaemon-rufen.md)
Kriegskonstrukt=[Kriegskonstrukt](fanwerk/talente/kriegskonstrukt.md)
Kroppzeuch!=[Kroppzeuch!](fanwerk/talente/kroppzeuch.md)
Krötenhaut=[Krötenhaut](fanwerk/bestiarium/kroetenhaut.md)
Kruga=[Kruga](fanwerk/bestiarium/kruga.md)
Kugelblitz=[Kugelblitz](fanwerk/zauber/kugelblitz.md)
Kultist in Mautmoreen=[Kultist in Mautmoreen](fanwerk/bestiarium/kultist-in-mautmoreen.md)
Labyrinth=[Labyrinth](fanwerk/zauber/labyrinth.md)
Lach=[Lach](fanwerk/zauber/lach.md)
Landbeine=[Landbeine](fanwerk/zauber/landbeine.md)
Langer Feueratem=[Langer Feueratem](fanwerk/zauber/langer-feueratem.md)
Lavaspalt=[Lavaspalt](fanwerk/zauber/lavaspalt.md)
Lavawand=[Lavawand](fanwerk/zauber/lavawand.md)
Lebende Wurzel=[Lebende Wurzel](fanwerk/bestiarium/lebende-wurzel.md)
Lebensblick=[Lebensblick](fanwerk/zauber/lebensblick.md)
Lebensfeuer=[Lebensfeuer](fanwerk/zauber/lebensfeuer.md)
Lebenssauger=[Lebenssauger](fanwerk/zauber/lebenssauger.md)
Lebensschild=[Lebensschild](fanwerk/zauber/lebensschild.md)
Lebensspende=[Lebensspende](fanwerk/zauber/lebensspende.md)
Lehrling in Aenk`Mator=[Lehrling in Aenk`Mator](fanwerk/bestiarium/lehrling-in-aenkmator.md)
Leibwächter=[Leibwächter](fanwerk/talente/leibwaechter.md)
Leibwächter=[Leibwächter](fanwerk/zauber/leibwaechter.md)
Leidteiler=[Leidteiler](fanwerk/zauber/leidteiler.md)
Letzter Stand=[Letzter Stand](fanwerk/zauber/letzter-stand.md)
Lichtexplosion=[Lichtexplosion](fanwerk/zauber/lichtexplosion.md)
Lichtodem=[Lichtodem](fanwerk/zauber/lichtodem.md)
Licht spüren=[Licht spüren](fanwerk/zauber/licht-spueren.md)
Lieblingszauber=[Lieblingszauber](fanwerk/talente/lieblingszauber.md)
Lios=[Lios](fanwerk/bestiarium/lios.md)
Lockruf=[Lockruf](fanwerk/zauber/lockruf.md)
Lokalisieren=[Lokalisieren](fanwerk/zauber/lokalisieren.md)
Lord Dammenhall=[Lord Dammenhall](fanwerk/bestiarium/lord-dammenhall.md)
Lufrelementardiener=[Lufrelementardiener](fanwerk/bestiarium/lufrelementardiener.md)
Luftdämon I=[Luftdämon I](fanwerk/bestiarium/luftdaemon-i.md)
Luftdämon II=[Luftdämon II](fanwerk/bestiarium/luftdaemon-ii.md)
Luftdämon III=[Luftdämon III](fanwerk/bestiarium/luftdaemon-iii.md)
Luftelementarbote=[Luftelementarbote](fanwerk/bestiarium/luftelementarbote.md)
Lügen spüren=[Lügen spüren](fanwerk/zauber/luegen-spueren.md)
Lydenia=[Lydenia](fanwerk/bestiarium/lydenia.md)
Mächtiges Ablenken=[Mächtiges Ablenken](fanwerk/zauber/maechtiges-ablenken.md)
Mächtiges Schwächen=[Mächtiges Schwächen](fanwerk/zauber/maechtiges-schwaechen.md)
Mächtiges Stören=[Mächtiges Stören](fanwerk/zauber/maechtiges-stoeren.md)
Mächtige Tränke=[Mächtige Tränke](fanwerk/talente/maechtige-traenke.md)
Magieresistenz=[Magieresistenz](fanwerk/zauber/magieresistenz.md)
Magiertöter=[Magiertöter](fanwerk/talente/magiertoeter.md)
Magische Faust=[Magische Faust](fanwerk/zauber/magische-faust.md)
Magische Lafette=[Magische Lafette](fanwerk/zauber/magische-lafette.md)
Magischer Blick=[Magischer Blick](fanwerk/zauber/magischer-blick.md)
Magisches Erbe=[Magisches Erbe](fanwerk/talente/magisches-erbe.md)
Magisches leuchten=[Magisches leuchten](fanwerk/zauber/magisches-leuchten.md)
Magische Wand=[Magische Wand](fanwerk/zauber/magische-wand.md)
Magnetischer Schild=[Magnetischer Schild](fanwerk/zauber/magnetischer-schild.md)
Mammut=[Mammut](fanwerk/bestiarium/mammut.md)
Manaentzug=[Manaentzug](fanwerk/zauber/manaentzug.md)
Mana geben und Nehmen=[Mana geben und Nehmen](fanwerk/zauber/mana-geben-und-nehmen.md)
Manakratzer=[Manakratzer](fanwerk/zauber/manakratzer.md)
Manaraub=[Manaraub](fanwerk/zauber/manaraub.md)
Mardossani Kavalier=[Mardossani Kavalier](fanwerk/bestiarium/mardossani-kavalier.md)
Märtyrer=[Märtyrer](fanwerk/zauber/maertyrer.md)
Maskentänzerin=[Maskentänzerin](fanwerk/bestiarium/maskentaenzerin.md)
Materielle Bindung=[Materielle Bindung](fanwerk/talente/materielle-bindung.md)
Mega-Skelett=[Mega-Skelett](fanwerk/bestiarium/mega-skelett.md)
Meister Schnarkel=[Meister Schnarkel](fanwerk/bestiarium/meister-schnarkel.md)
Menschensklave=[Menschensklave](fanwerk/bestiarium/menschensklave.md)
Metall erhitzen oder abkühlen=[Metall erhitzen oder abkühlen](fanwerk/zauber/metall-erhitzen-oder-abkuehlen.md)
Metall formen=[Metall formen](fanwerk/zauber/metall-formen.md)
Meteor=[Meteor](fanwerk/zauber/meteor.md)
Minderer Leichnam=[Minderer Leichnam](fanwerk/bestiarium/minderer-leichnam.md)
Minderer Schutz=[Minderer Schutz](fanwerk/zauber/minderer-schutz.md)
Mit Anlauf!=[Mit Anlauf!](fanwerk/talente/mit-anlauf.md)
Mokaner Fährtenleser=[Mokaner Fährtenleser](fanwerk/bestiarium/mokaner-faehrtenleser.md)
Monstertöter=[Monstertöter](fanwerk/talente/monstertoeter.md)
Morg Bulgash=[Morg Bulgash](fanwerk/bestiarium/morg-bulgash.md)
Mudaks, die Grünhaut=[Mudaks, die Grünhaut](fanwerk/bestiarium/mudaks-die-gruenhaut.md)
Mumie erwecken=[Mumie erwecken](fanwerk/zauber/mumie-erwecken.md)
Mutierte Riesenratte=[Mutierte Riesenratte](fanwerk/bestiarium/mutierte-riesenratte.md)
Nachglühen=[Nachglühen](fanwerk/talente/nachgluehen.md)
Nachtschwärmer=[Nachtschwärmer](fanwerk/talente/nachtschwaermer.md)
Nafuri Söldner=[Nafuri Söldner](fanwerk/bestiarium/nafuri-soeldner.md)
Name=[Name](fanwerk/bestiarium/name.md)
Nancor der Bärenwüter=[Nancor der Bärenwüter](fanwerk/bestiarium/nancor-der-baerenwueter.md)
Narrländer Alchemist=[Narrländer Alchemist](fanwerk/bestiarium/narrlaender-alchemist.md)
Natürliche Auslese=[Natürliche Auslese](fanwerk/talente/natuerliche-auslese.md)
Nekrolyth=[Nekrolyth](fanwerk/bestiarium/nekrolyth.md)
Nico Mavelli=[Nico Mavelli](fanwerk/bestiarium/nico-mavelli.md)
Niederer Dämon rufen=[Niederer Dämon rufen](fanwerk/zauber/niederer-daemon-rufen.md)
Niedermähen=[Niedermähen](fanwerk/talente/niedermaehen.md)
Nordeker Ritter=[Nordeker Ritter](fanwerk/bestiarium/nordeker-ritter.md)
Notfall=[Notfall](fanwerk/talente/notfall.md)
Objekt der Begierde=[Objekt der Begierde](fanwerk/zauber/objekt-der-begierde.md)
Objekt lesen=[Objekt lesen](fanwerk/zauber/objekt-lesen.md)
Ogergestalt=[Ogergestalt](fanwerk/zauber/ogergestalt.md)
Optimierte Verwertung=[Optimierte Verwertung](fanwerk/talente/optimierte-verwertung.md)
Pass auf!=[Pass auf!](fanwerk/talente/pass-auf.md)
Pein=[Pein](fanwerk/zauber/pein.md)
Pfadfinder=[Pfadfinder](fanwerk/zauber/pfadfinder.md)
Pfeilsporenpilz=[Pfeilsporenpilz](fanwerk/bestiarium/pfeilsporenpilz.md)
Phantom=[Phantom](fanwerk/zauber/phantom.md)
Phantomhexer=[Phantomhexer](fanwerk/bestiarium/phantomhexer.md)
Privatgespräch=[Privatgespräch](fanwerk/zauber/privatgespraech.md)
Prophezeihung=[Prophezeihung](fanwerk/zauber/prophezeihung.md)
Puppenspieler=[Puppenspieler](fanwerk/talente/puppenspieler.md)
Rache der Elemente=[Rache der Elemente](fanwerk/talente/rache-der-elemente.md)
Radau=[Radau](fanwerk/zauber/radau.md)
Rankenwaffe=[Rankenwaffe](fanwerk/zauber/rankenwaffe.md)
Rätselstimme=[Rätselstimme](fanwerk/zauber/raetselstimme.md)
Rattenkönig=[Rattenkönig](fanwerk/bestiarium/rattenkoenig.md)
Rattenkönig Schnabbler=[Rattenkönig Schnabbler](fanwerk/bestiarium/rattenkoenig-schnabbler.md)
Rattenoger=[Rattenoger](fanwerk/bestiarium/rattenoger.md)
Rattling=[Rattling](fanwerk/bestiarium/rattling.md)
Rattling Giftzauberer=[Rattling Giftzauberer](fanwerk/bestiarium/rattling-giftzauberer.md)
Rattling Kriegshäuptling=[Rattling Kriegshäuptling](fanwerk/bestiarium/rattling-kriegshaeuptling.md)
Rattling Seuchenpriester=[Rattling Seuchenpriester](fanwerk/bestiarium/rattling-seuchenpriester.md)
Räuber=[Räuber](fanwerk/bestiarium/raeuber.md)
Raubtierpranken=[Raubtierpranken](fanwerk/talente/raubtierpranken.md)
Reanimation=[Reanimation](fanwerk/talente/reanimation.md)
Regeneration=[Regeneration](fanwerk/zauber/regeneration.md)
Rekrut der Reiter der Morgenröte=[Rekrut der Reiter der Morgenröte](fanwerk/bestiarium/rekrut-der-reiter-der-morgenroete.md)
Remnaton=[Remnaton](fanwerk/bestiarium/remnaton.md)
Resistent=[Resistent](fanwerk/talente/resistent.md)
Riesenaffe=[Riesenaffe](fanwerk/bestiarium/riesenaffe.md)
Riesenblütig=[Riesenblütig](fanwerk/talente/riesenbluetig.md)
Riesengestalt=[Riesengestalt](fanwerk/zauber/riesengestalt.md)
Riesenpterodactylus=[Riesenpterodactylus](fanwerk/bestiarium/riesenpterodactylus.md)
Riesensumpfotter=[Riesensumpfotter](fanwerk/bestiarium/riesensumpfotter.md)
Riesentöter=[Riesentöter](fanwerk/talente/riesentoeter.md)
Ritter 01=[Ritter 01](fanwerk/bestiarium/ritter-01.md)
Ritter 04=[Ritter 04](fanwerk/bestiarium/ritter-04.md)
Ritter 08=[Ritter 08](fanwerk/bestiarium/ritter-08.md)
Ritter 12=[Ritter 12](fanwerk/bestiarium/ritter-12.md)
Ritter Gungart=[Ritter Gungart](fanwerk/bestiarium/ritter-gungart.md)
Rogg (Umbar-Barbar)=[Rogg (Umbar-Barbar)](fanwerk/bestiarium/rogg-umbar-barbar.md)
Rohe Magie=[Rohe Magie](fanwerk/talente/rohe-magie.md)
Rudelführer=[Rudelführer](fanwerk/talente/rudelfuehrer.md)
Ruf der Wildnis=[Ruf der Wildnis](fanwerk/talente/ruf-der-wildnis.md)
Ruf des Lichts=[Ruf des Lichts](fanwerk/zauber/ruf-des-lichts.md)
Rune des Lebens=[Rune des Lebens](fanwerk/zauber/rune-des-lebens.md)
Rüstung des Lichts=[Rüstung des Lichts](fanwerk/zauber/ruestung-des-lichts.md)
Rüstung verzaubern=[Rüstung verzaubern](fanwerk/zauber/ruestung-verzaubern.md)
Ryan Dougal=[Ryan Dougal](fanwerk/bestiarium/ryan-dougal.md)
Säbelzahntiger=[Säbelzahntiger](fanwerk/bestiarium/saebelzahntiger.md)
Samtpfote=[Samtpfote](fanwerk/talente/samtpfote.md)
Sandgrab=[Sandgrab](fanwerk/zauber/sandgrab.md)
Sandlanze=[Sandlanze](fanwerk/zauber/sandlanze.md)
Sandodem=[Sandodem](fanwerk/zauber/sandodem.md)
Sandschild=[Sandschild](fanwerk/zauber/sandschild.md)
Sandstrahl=[Sandstrahl](fanwerk/zauber/sandstrahl.md)
Sandsturm=[Sandsturm](fanwerk/zauber/sandsturm.md)
Sandwoge=[Sandwoge](fanwerk/zauber/sandwoge.md)
Sanuriel=[Sanuriel](fanwerk/bestiarium/sanuriel.md)
Säureatem=[Säureatem](fanwerk/zauber/saeureatem.md)
Säurelanze=[Säurelanze](fanwerk/zauber/saeurelanze.md)
Säurenebel=[Säurenebel](fanwerk/zauber/saeurenebel.md)
Säurestrahl=[Säurestrahl](fanwerk/zauber/saeurestrahl.md)
Schadenfreude=[Schadenfreude](fanwerk/talente/schadenfreude.md)
Schattenexplosion=[Schattenexplosion](fanwerk/zauber/schattenexplosion.md)
Schattenkultist=[Schattenkultist](fanwerk/bestiarium/schattenkultist.md)
Schattenmantel=[Schattenmantel](fanwerk/zauber/schattenmantel.md)
Schattenodem=[Schattenodem](fanwerk/zauber/schattenodem.md)
Schattenpriester=[Schattenpriester](fanwerk/bestiarium/schattenpriester.md)
Schattenrüstung=[Schattenrüstung](fanwerk/zauber/schattenruestung.md)
Schattenstärke=[Schattenstärke](fanwerk/talente/schattenstaerke.md)
Schattenwolf=[Schattenwolf](fanwerk/bestiarium/schattenwolf.md)
SCHIFF AHOI=[SCHIFF AHOI](fanwerk/schiff-ahoi/schiff-ahoi.md)
Schilddeckung=[Schilddeckung](fanwerk/talente/schilddeckung.md)
Schildkonter=[Schildkonter](fanwerk/talente/schildkonter.md)
Schildvorstoß=[Schildvorstoß](fanwerk/talente/schildvorstoss.md)
Schildwacht=[Schildwacht](fanwerk/talente/schildwacht.md)
Schildwall=[Schildwall](fanwerk/talente/schildwall.md)
Schildwehr=[Schildwehr](fanwerk/talente/schildwehr.md)
Schimmerross rufen=[Schimmerross rufen](fanwerk/zauber/schimmerross-rufen.md)
Schlächter=[Schlächter](fanwerk/bestiarium/schlaechter.md)
Schlachtreihe=[Schlachtreihe](fanwerk/talente/schlachtreihe.md)
Schlagkraft=[Schlagkraft](fanwerk/talente/schlagkraft.md)
Schleimwand=[Schleimwand](fanwerk/zauber/schleimwand.md)
Schmerzhafter Schuss=[Schmerzhafter Schuss](fanwerk/talente/schmerzhafter-schuss.md)
Schmierfleck=[Schmierfleck](fanwerk/zauber/schmierfleck.md)
Schnappaal=[Schnappaal](fanwerk/bestiarium/schnappaal.md)
Schneeriese=[Schneeriese](fanwerk/bestiarium/schneeriese.md)
Schnelle Heilung=[Schnelle Heilung](fanwerk/talente/schnelle-heilung.md)
Schnelles Brauen=[Schnelles Brauen](fanwerk/talente/schnelles-brauen.md)
Schnellzaubern=[Schnellzaubern](fanwerk/talente/schnellzaubern.md)
Schnellziehen=[Schnellziehen](fanwerk/talente/schnellziehen.md)
Schock=[Schock](fanwerk/zauber/schock.md)
Schockwaffe=[Schockwaffe](fanwerk/zauber/schockwaffe.md)
Schreckensdachs=[Schreckensdachs](fanwerk/bestiarium/schreckensdachs.md)
Schreckensklinge=[Schreckensklinge](fanwerk/zauber/schreckensklinge.md)
Schriftgelehrter=[Schriftgelehrter](fanwerk/talente/schriftgelehrter.md)
Schützende Schatten=[Schützende Schatten](fanwerk/zauber/schuetzende-schatten.md)
Schutz=[Schutz](fanwerk/zauber/schutz.md)
Schutzkreis gegen Tiere=[Schutzkreis gegen Tiere](fanwerk/zauber/schutzkreis-gegen-tiere.md)
Schutz vor Dunkelheit=[Schutz vor Dunkelheit](fanwerk/zauber/schutz-vor-dunkelheit.md)
Schutz vor Licht=[Schutz vor Licht](fanwerk/zauber/schutz-vor-licht.md)
Schwächender Zauber=[Schwächender Zauber](fanwerk/talente/schwaechender-zauber.md)
Schwächen=[Schwächen](fanwerk/zauber/schwaechen.md)
Schwarm herbeirufen=[Schwarm herbeirufen](fanwerk/zauber/schwarm-herbeirufen.md)
Schwebender Spiegel=[Schwebender Spiegel](fanwerk/zauber/schwebender-spiegel.md)
Schwebende Schutzsphäre=[Schwebende Schutzsphäre](fanwerk/zauber/schwebende-schutzsphaere.md)
Schwerkraftfeld=[Schwerkraftfeld](fanwerk/zauber/schwerkraftfeld.md)
Schwerkraft umkehren=[Schwerkraft umkehren](fanwerk/zauber/schwerkraft-umkehren.md)
Schwimmen=[Schwimmen](fanwerk/zauber/schwimmen.md)
Seelenbindung=[Seelenbindung](fanwerk/talente/seelenbindung.md)
Seelengefäss=[Seelengefäss](fanwerk/zauber/seelengefaess.md)
Seelenräuber=[Seelenräuber](fanwerk/talente/seelenraeuber.md)
Selbstheilung=[Selbstheilung](fanwerk/zauber/selbstheilung.md)
Selbstzerstörung=[Selbstzerstörung](fanwerk/talente/selbstzerstoerung.md)
Sensenmann=[Sensenmann](fanwerk/bestiarium/sensenmann.md)
Seuchenschneide=[Seuchenschneide](fanwerk/zauber/seuchenschneide.md)
Sichtverbindung=[Sichtverbindung](fanwerk/zauber/sichtverbindung.md)
Sinda=[Sinda](fanwerk/bestiarium/sinda.md)
Sinne schärfen=[Sinne schärfen](fanwerk/zauber/sinne-schaerfen.md)
Sinnestäuscher=[Sinnestäuscher](fanwerk/talente/sinnestaeuscher.md)
Skelettdrache=[Skelettdrache](fanwerk/bestiarium/skelettdrache.md)
Skelettkrieger=[Skelettkrieger](fanwerk/bestiarium/skelettkrieger.md)
Skelettmagier=[Skelettmagier](fanwerk/bestiarium/skelettmagier.md)
Skelettschütze=[Skelettschütze](fanwerk/bestiarium/skelettschuetze.md)
Slayerwaffe=[Slayerwaffe](fanwerk/zauber/slayerwaffe.md)
Sonar=[Sonar](fanwerk/zauber/sonar.md)
Sonnenkraft=[Sonnenkraft](fanwerk/talente/sonnenkraft.md)
Spähposten=[Spähposten](fanwerk/zauber/spaehposten.md)
Spektakel=[Spektakel](fanwerk/zauber/spektakel.md)
Spiegelbild=[Spiegelbild](fanwerk/zauber/spiegelbild.md)
Spiegeltrick=[Spiegeltrick](fanwerk/talente/spiegeltrick.md)
Sprache verstehen=[Sprache verstehen](fanwerk/zauber/sprache-verstehen.md)
Sprachgenie=[Sprachgenie](fanwerk/talente/sprachgenie.md)
Sprengmeister=[Sprengmeister](fanwerk/talente/sprengmeister.md)
Sprint=[Sprint](fanwerk/talente/sprint.md)
Sprungangriff=[Sprungangriff](fanwerk/talente/sprungangriff.md)
Spur verwischen=[Spur verwischen](fanwerk/zauber/spur-verwischen.md)
Stadtwache in den Freien Landen=[Stadtwache in den Freien Landen](fanwerk/bestiarium/stadtwache-in-den-freien-landen.md)
Stärkung=[Stärkung](fanwerk/talente/staerkung.md)
Stasis=[Stasis](fanwerk/zauber/stasis.md)
Stein formen=[Stein formen](fanwerk/zauber/stein-formen.md)
Steingespür=[Steingespür](fanwerk/talente/steingespuer.md)
Steingestalt=[Steingestalt](fanwerk/zauber/steingestalt.md)
Steinverschmelzung=[Steinverschmelzung](fanwerk/zauber/steinverschmelzung.md)
Steinwaffe=[Steinwaffe](fanwerk/zauber/steinwaffe.md)
Sternheider Forscher=[Sternheider Forscher](fanwerk/bestiarium/sternheider-forscher.md)
Stig=[Stig](fanwerk/bestiarium/stig.md)
Stimme ändern=[Stimme ändern](fanwerk/zauber/stimme-aendern.md)
Stimme der Finsternis=[Stimme der Finsternis](fanwerk/zauber/stimme-der-finsternis.md)
Stinkbombe=[Stinkbombe](fanwerk/zauber/stinkbombe.md)
Stirb, Feigling!=[Stirb, Feigling!](fanwerk/talente/stirb-feigling.md)
Stolpervogel=[Stolpervogel](fanwerk/bestiarium/stolpervogel.md)
Stören=[Stören](fanwerk/zauber/stoeren.md)
Sturmmeerkatze=[Sturmmeerkatze](fanwerk/bestiarium/sturmmeerkatze.md)
Sturmsegler=[Sturmsegler](fanwerk/bestiarium/sturmsegler.md)
Substanz=[Substanz](fanwerk/talente/substanz.md)
Suggestion=[Suggestion](fanwerk/zauber/suggestion.md)
Sumpfechse=[Sumpfechse](fanwerk/bestiarium/sumpfechse.md)
Taktiker=[Taktiker](fanwerk/talente/taktiker.md)
Talente erkennen=[Talente erkennen](fanwerk/zauber/talente-erkennen.md)
Talentzauber 1=[Talentzauber 1](fanwerk/zauber/talentzauber-1.md)
Talentzauber 2=[Talentzauber 2](fanwerk/zauber/talentzauber-2.md)
Tarc Trepios=[Tarc Trepios](fanwerk/bestiarium/tarc-trepios.md)
Tarnung=[Tarnung](fanwerk/zauber/tarnung.md)
Tarr-Novize=[Tarr-Novize](fanwerk/bestiarium/tarr-novize.md)
Techniker=[Techniker](fanwerk/talente/techniker.md)
Telekinetischer Wurf=[Telekinetischer Wurf](fanwerk/zauber/telekinetischer-wurf.md)
Telepathie=[Telepathie](fanwerk/zauber/telepathie.md)
Tentakelranken=[Tentakelranken](fanwerk/zauber/tentakelranken.md)
Teufelchen rufen=[Teufelchen rufen](fanwerk/zauber/teufelchen-rufen.md)
Thema finden=[Thema finden](fanwerk/zauber/thema-finden.md)
Tiefe Wunde=[Tiefe Wunde](fanwerk/talente/tiefe-wunde.md)
Tiere fernhalten=[Tiere fernhalten](fanwerk/zauber/tiere-fernhalten.md)
Tier oder Pflanze herbeirufen=[Tier oder Pflanze herbeirufen](fanwerk/zauber/tier-oder-pflanze-herbeirufen.md)
Tiersprache=[Tiersprache](fanwerk/zauber/tiersprache.md)
Tigerskelett=[Tigerskelett](fanwerk/bestiarium/tigerskelett.md)
Tintenkraken=[Tintenkraken](fanwerk/bestiarium/tintenkraken.md)
Todesklinge=[Todesklinge](fanwerk/zauber/todesklinge.md)
Todesschatten=[Todesschatten](fanwerk/talente/todesschatten.md)
Todesschutz=[Todesschutz](fanwerk/zauber/todesschutz.md)
Tod von Oben=[Tod von Oben](fanwerk/talente/tod-von-oben.md)
Tonkriegergolem=[Tonkriegergolem](fanwerk/bestiarium/tonkriegergolem.md)
Totemtier=[Totemtier](fanwerk/zauber/totemtier.md)
Totengeläut=[Totengeläut](fanwerk/talente/totengelaeut.md)
Totenklage=[Totenklage](fanwerk/zauber/totenklage.md)
Totenwache=[Totenwache](fanwerk/zauber/totenwache.md)
Tote Verbindung=[Tote Verbindung](fanwerk/talente/tote-verbindung.md)
Trägheit=[Trägheit](fanwerk/zauber/traegheit.md)
Trank-Kombination=[Trank-Kombination](fanwerk/talente/trank-kombination.md)
Traumzauber=[Traumzauber](fanwerk/zauber/traumzauber.md)
Treibsand=[Treibsand](fanwerk/zauber/treibsand.md)
Triumphgeheul=[Triumphgeheul](fanwerk/talente/triumphgeheul.md)
Trollgestalt=[Trollgestalt](fanwerk/zauber/trollgestalt.md)
Umbar Barbar=[Umbar Barbar](fanwerk/bestiarium/umbar-barbar.md)
Umbarlageier=[Umbarlageier](fanwerk/bestiarium/umbarlageier.md)
Umgebung spüren=[Umgebung spüren](fanwerk/talente/umgebung-spueren.md)
Umwerfender Wurf=[Umwerfender Wurf](fanwerk/talente/umwerfender-wurf.md)
Unbeugsame Abwehr=[Unbeugsame Abwehr](fanwerk/talente/unbeugsame-abwehr.md)
Unterbrecher=[Unterbrecher](fanwerk/talente/unterbrecher.md)
Untote Klauen=[Untote Klauen](fanwerk/talente/untote-klauen.md)
Untote Mannshand=[Untote Mannshand](fanwerk/bestiarium/untote-mannshand.md)
Untoter Goblin=[Untoter Goblin](fanwerk/bestiarium/untoter-goblin.md)
Untoter Oger=[Untoter Oger](fanwerk/bestiarium/untoter-oger.md)
Untoter Ork=[Untoter Ork](fanwerk/bestiarium/untoter-ork.md)
Untoter Priester=[Untoter Priester](fanwerk/bestiarium/untoter-priester.md)
Untoter Wächter=[Untoter Wächter](fanwerk/bestiarium/untoter-waechter.md)
Untote Werratte=[Untote Werratte](fanwerk/bestiarium/untote-werratte.md)
Untrügliche Sinne=[Untrügliche Sinne](fanwerk/talente/untruegliche-sinne.md)
Unverwundbarkeit=[Unverwundbarkeit](fanwerk/zauber/unverwundbarkeit.md)
Vampirfäuste=[Vampirfäuste](fanwerk/zauber/vampirfaeuste.md)
Vampirische Heilung=[Vampirische Heilung](fanwerk/zauber/vampirische-heilung.md)
Vampirklinge=[Vampirklinge](fanwerk/zauber/vampirklinge.md)
Vandrianischer Minnesänger=[Vandrianischer Minnesänger](fanwerk/bestiarium/vandrianischer-minnesaenger.md)
Vandrianischer Ordensheiler=[Vandrianischer Ordensheiler](fanwerk/bestiarium/vandrianischer-ordensheiler.md)
Vandrianischer Ordensritter=[Vandrianischer Ordensritter](fanwerk/bestiarium/vandrianischer-ordensritter.md)
Vandrianischer Waffenknecht=[Vandrianischer Waffenknecht](fanwerk/bestiarium/vandrianischer-waffenknecht.md)
Varissa=[Varissa](fanwerk/bestiarium/varissa.md)
Verarbeiten=[Verarbeiten](fanwerk/zauber/verarbeiten.md)
Verbergende Aura=[Verbergende Aura](fanwerk/zauber/verbergende-aura.md)
Verbesserte Magische Faust=[Verbesserte Magische Faust](fanwerk/zauber/verbesserte-magische-faust.md)
Verbesserte Magische Waffe=[Verbesserte Magische Waffe](fanwerk/zauber/verbesserte-magische-waffe.md)
Verbessertes Ablenken=[Verbessertes Ablenken](fanwerk/zauber/verbessertes-ablenken.md)
Verbesserte Selbstheilung=[Verbesserte Selbstheilung](fanwerk/zauber/verbesserte-selbstheilung.md)
Verbessertes Schwächen=[Verbessertes Schwächen](fanwerk/zauber/verbessertes-schwaechen.md)
Verbessertes Stören=[Verbessertes Stören](fanwerk/zauber/verbessertes-stoeren.md)
Verborgene Illusion=[Verborgene Illusion](fanwerk/zauber/verborgene-illusion.md)
Verbot=[Verbot](fanwerk/zauber/verbot.md)
Verdammnis=[Verdammnis](fanwerk/talente/verdammnis.md)
Verdorren=[Verdorren](fanwerk/zauber/verdorren.md)
Verdunklungshammer=[Verdunklungshammer](fanwerk/talente/verdunklungshammer.md)
Verflüssigen=[Verflüssigen](fanwerk/zauber/verfluessigen.md)
Vergangenes sehen=[Vergangenes sehen](fanwerk/zauber/vergangenes-sehen.md)
Vergebung=[Vergebung](fanwerk/talente/vergebung.md)
Vergiss=[Vergiss](fanwerk/zauber/vergiss.md)
Verjüngen=[Verjüngen](fanwerk/zauber/verjuengen.md)
Verkrüppeln 1=[Verkrüppeln 1](fanwerk/zauber/verkrueppeln-1.md)
Verkrüppeln 2=[Verkrüppeln 2](fanwerk/zauber/verkrueppeln-2.md)
Verlangen=[Verlangen](fanwerk/zauber/verlangen.md)
Verschicken=[Verschicken](fanwerk/zauber/verschicken.md)
Verschlinger 1=[Verschlinger 1](fanwerk/zauber/verschlinger-1.md)
Verschlinger 2=[Verschlinger 2](fanwerk/zauber/verschlinger-2.md)
Verschlinger 3=[Verschlinger 3](fanwerk/zauber/verschlinger-3.md)
Verschwinde=[Verschwinde](fanwerk/zauber/verschwinde.md)
Verspotten=[Verspotten](fanwerk/talente/verspotten.md)
Verstärkter Schutz=[Verstärkter Schutz](fanwerk/zauber/verstaerkter-schutz.md)
Versteinern=[Versteinern](fanwerk/zauber/versteinern.md)
Verteidiger=[Verteidiger](fanwerk/talente/verteidiger.md)
Vertrautenzauber=[Vertrautenzauber](fanwerk/talente/vertrautenzauber.md)
Verzauberter Besen=[Verzauberter Besen](fanwerk/bestiarium/verzauberter-besen.md)
Verzweiflung=[Verzweiflung](fanwerk/zauber/verzweiflung.md)
Vestracher Einbrecher=[Vestracher Einbrecher](fanwerk/bestiarium/vestracher-einbrecher.md)
Vier Arme=[Vier Arme](fanwerk/zauber/vier-arme.md)
Virgil=[Virgil](fanwerk/bestiarium/virgil.md)
Vision=[Vision](fanwerk/zauber/vision.md)
Vladek Crumm=[Vladek Crumm](fanwerk/bestiarium/vladek-crumm.md)
Vor Konstrukten verstecken=[Vor Konstrukten verstecken](fanwerk/zauber/vor-konstrukten-verstecken.md)
Vor Tieren verstecken=[Vor Tieren verstecken](fanwerk/zauber/vor-tieren-verstecken.md)
Vor Untoten verstecken=[Vor Untoten verstecken](fanwerk/zauber/vor-untoten-verstecken.md)
Waffe beleben=[Waffe beleben](fanwerk/zauber/waffe-beleben.md)
Waffe herbeirufen=[Waffe herbeirufen](fanwerk/zauber/waffe-herbeirufen.md)
Walküre von Wyndstett=[Walküre von Wyndstett](fanwerk/bestiarium/walkuere-von-wyndstett.md)
Wand aus Dunkelheit=[Wand aus Dunkelheit](fanwerk/zauber/wand-aus-dunkelheit.md)
Wand aus Licht=[Wand aus Licht](fanwerk/zauber/wand-aus-licht.md)
Wand der Enthüllung=[Wand der Enthüllung](fanwerk/zauber/wand-der-enthuellung.md)
Wasser atmen=[Wasser atmen](fanwerk/zauber/wasser-atmen.md)
Weihen=[Weihen](fanwerk/zauber/weihen.md)
Werkzeug=[Werkzeug](fanwerk/bestiarium/werkzeug.md)
Wilder Rattling=[Wilder Rattling](fanwerk/bestiarium/wilder-rattling.md)
Wildwuchs=[Wildwuchs](fanwerk/zauber/wildwuchs.md)
Wilfried von Eibenhöh=[Wilfried von Eibenhöh](fanwerk/bestiarium/wilfried-von-eibenhoeh.md)
Wind kontrollieren=[Wind kontrollieren](fanwerk/zauber/wind-kontrollieren.md)
Wirbelwind=[Wirbelwind](fanwerk/zauber/wirbelwind.md)
Wissen der Welt=[Wissen der Welt](fanwerk/zauber/wissen-der-welt.md)
Woge der Zerstörung=[Woge der Zerstörung](fanwerk/zauber/woge-der-zerstoerung.md)
Wolfbart=[Wolfbart](fanwerk/bestiarium/wolfbart.md)
Wolke der Ablenkung=[Wolke der Ablenkung](fanwerk/zauber/wolke-der-ablenkung.md)
Wolke der Schwäche=[Wolke der Schwäche](fanwerk/zauber/wolke-der-schwaeche.md)
Wolke der Störung=[Wolke der Störung](fanwerk/zauber/wolke-der-stoerung.md)
Wolke des Wahnsinns=[Wolke des Wahnsinns](fanwerk/zauber/wolke-des-wahnsinns.md)
Wolkenreise=[Wolkenreise](fanwerk/zauber/wolkenreise.md)
Wollnashorn=[Wollnashorn](fanwerk/bestiarium/wollnashorn.md)
Wunde übertragen=[Wunde übertragen](fanwerk/zauber/wunde-uebertragen.md)
Wunsch 1=[Wunsch 1](fanwerk/zauber/wunsch-1.md)
Wunsch 2=[Wunsch 2](fanwerk/zauber/wunsch-2.md)
Wunsch 3=[Wunsch 3](fanwerk/zauber/wunsch-3.md)
Würgegriff=[Würgegriff](fanwerk/zauber/wuergegriff.md)
Wyndländischer Schwarzmagier=[Wyndländischer Schwarzmagier](fanwerk/bestiarium/wyndlaendischer-schwarzmagier.md)
Ynnari (Schwester des Waldes)=[Ynnari (Schwester des Waldes)](fanwerk/bestiarium/ynnari-schwester-des-waldes.md)
Zasarischer Feuermagier=[Zasarischer Feuermagier](fanwerk/bestiarium/zasarischer-feuermagier.md)
Zasarischer Kauffahrer=[Zasarischer Kauffahrer](fanwerk/bestiarium/zasarischer-kauffahrer.md)
Zasarischer Märchenerzähler=[Zasarischer Märchenerzähler](fanwerk/bestiarium/zasarischer-maerchenerzaehler.md)
Zauber aufheben=[Zauber aufheben](fanwerk/zauber/zauber-aufheben.md)
Zauberauge=[Zauberauge](fanwerk/zauber/zauberauge.md)
Zauberbeschleunigung=[Zauberbeschleunigung](fanwerk/talente/zauberbeschleunigung.md)
Zauberdehnung=[Zauberdehnung](fanwerk/talente/zauberdehnung.md)
Zauber der Wildnis=[Zauber der Wildnis](fanwerk/talente/zauber-der-wildnis.md)
Zauberecho=[Zauberecho](fanwerk/talente/zauberecho.md)
Zauber einfangen=[Zauber einfangen](fanwerk/zauber/zauber-einfangen.md)
Zauber erkennen=[Zauber erkennen](fanwerk/zauber/zauber-erkennen.md)
Zauber=[Zauber](fanwerk/zauber/zauber.md)
Zauberglyphe=[Zauberglyphe](fanwerk/zauber/zauberglyphe.md)
Zauberimmunität=[Zauberimmunität](fanwerk/zauber/zauberimmunitaet.md)
Zauberkäfig=[Zauberkäfig](fanwerk/zauber/zauberkaefig.md)
Zauberquerschläger=[Zauberquerschläger](fanwerk/talente/zauberquerschlaeger.md)
Zauberspiegel=[Zauberspiegel](fanwerk/zauber/zauberspiegel.md)
Zauber stören=[Zauber stören](fanwerk/talente/zauber-stoeren.md)
Zauberverbot=[Zauberverbot](fanwerk/zauber/zauberverbot.md)
Zauberverlängerung=[Zauberverlängerung](fanwerk/talente/zauberverlaengerung.md)
Zauber verleihen=[Zauber verleihen](fanwerk/talente/zauber-verleihen.md)
Zauberwasser=[Zauberwasser](fanwerk/talente/zauberwasser.md)
Zauberwelle=[Zauberwelle](fanwerk/talente/zauberwelle.md)
Zauberzeichen=[Zauberzeichen](fanwerk/zauber/zauberzeichen.md)
Zeitansage=[Zeitansage](fanwerk/zauber/zeitansage.md)
Zeitinterferenz=[Zeitinterferenz](fanwerk/zauber/zeitinterferenz.md)
Zementieren=[Zementieren](fanwerk/zauber/zementieren.md)
Zen-Schütze=[Zen-Schütze](fanwerk/talente/zen-schuetze.md)
Zielmarkierung=[Zielmarkierung](fanwerk/zauber/zielmarkierung.md)
Zombiebär=[Zombiebär](fanwerk/bestiarium/zombiebaer.md)
Zombiedrache=[Zombiedrache](fanwerk/bestiarium/zombiedrache.md)
Zombiegoblin=[Zombiegoblin](fanwerk/bestiarium/zombiegoblin.md)
Zombiekeiler=[Zombiekeiler](fanwerk/bestiarium/zombiekeiler.md)
Zombieoger=[Zombieoger](fanwerk/bestiarium/zombieoger.md)
Zombieork=[Zombieork](fanwerk/bestiarium/zombieork.md)
Zombieriesenratte=[Zombieriesenratte](fanwerk/bestiarium/zombieriesenratte.md)
Zombie Sekretärin=[Zombie Sekretärin](fanwerk/bestiarium/zombie-sekretaerin.md)
Zombietroll=[Zombietroll](fanwerk/bestiarium/zombietroll.md)
Zombiewolf=[Zombiewolf](fanwerk/bestiarium/zombiewolf.md)
Zone des Friedens=[Zone des Friedens](fanwerk/zauber/zone-des-friedens.md)
Zorn des Lichts=[Zorn des Lichts](fanwerk/zauber/zorn-des-lichts.md)
Zuflucht=[Zuflucht](fanwerk/zauber/zuflucht.md)
Zweites Leben=[Zweites Leben](fanwerk/zauber/zweites-leben.md)
Zwergensicht=[Zwergensicht](fanwerk/zauber/zwergensicht.md)
Zwergensklave=[Zwergensklave](fanwerk/bestiarium/zwergensklave.md)
Zwergischer Minenarbeiter=[Zwergischer Minenarbeiter](fanwerk/bestiarium/zwergischer-minenarbeiter.md)
