Ablenken=[Ablenken](../../fanwerk/zauber/ablenken.md)
Aderplatzer=[Aderplatzer](../../fanwerk/zauber/aderplatzer.md)
Alle Zauber aufheben=[Alle Zauber aufheben](../../fanwerk/zauber/alle-zauber-aufheben.md)
Allheilung=[Allheilung](../../grw/zauber/allheilung.md)
Altern=[Altern](../../fanwerk/zauber/altern.md)
Amok=[Amok](../../fanwerk/zauber/amok.md)
Anlocken=[Anlocken](../../fanwerk/zauber/anlocken.md)
Anpassung=[Anpassung](../../fanwerk/zauber/anpassung.md)
Antimagie=[Antimagie](../../fanwerk/zauber/antimagie.md)
Arkane Aufladung=[Arkane Aufladung](../../fanwerk/zauber/arkane-aufladung.md)
Arkane Faust=[Arkane Faust](../../fanwerk/zauber/arkane-faust.md)
Arkane Klaue=[Arkane Klaue](../../fanwerk/zauber/arkane-klaue.md)
Arkaner Stiefel=[Arkaner Stiefel](../../fanwerk/zauber/arkaner-stiefel.md)
Arkanes Schwert=[Arkanes Schwert](../../grw/zauber/arkanes-schwert.md)
Atemfrei=[Atemfrei](../../fanwerk/zauber/atemfrei.md)
Auferstehung=[Auferstehung](../../fanwerk/zauber/auferstehung.md)
Augenwand=[Augenwand](../../fanwerk/zauber/augenwand.md)
Aura der Vergeltung=[Aura der Vergeltung](../../fanwerk/zauber/aura-der-vergeltung.md)
Balancieren=[Balancieren](../../grw/zauber/balancieren.md)
Ballistischer Flug=[Ballistischer Flug](../../fanwerk/zauber/ballistischer-flug.md)
Bannen=[Bannen](../../grw/zauber/bannen.md)
Bannsphäre=[Bannsphäre](../../fanwerk/zauber/bannsphaere.md)
Besessenheit 1=[Besessenheit 1](../../fanwerk/zauber/besessenheit-1.md)
Besessenheit 2=[Besessenheit 2](../../fanwerk/zauber/besessenheit-2.md)
Beulenpest=[Beulenpest](../../fanwerk/zauber/beulenpest.md)
Blenden=[Blenden](../../grw/zauber/blenden.md)
Blitz=[Blitz](../../grw/zauber/blitz.md)
Blitzschild=[Blitzschild](../../fanwerk/zauber/blitzschild.md)
Blutentzug=[Blutentzug](../../fanwerk/zauber/blutentzug.md)
Blutige Berührung=[Blutige Berührung](../../fanwerk/zauber/blutige-beruehrung.md)
Blut kochen=[Blut kochen](../../grw/zauber/blut-kochen.md)
Blutnebel=[Blutnebel](../../fanwerk/zauber/blutnebel.md)
Blutraub=[Blutraub](../../fanwerk/zauber/blutraub.md)
Blut-Zaubertrank=[Blut-Zaubertrank](../../fanwerk/talente/blut-zaubertrank.md)
Bodenstacheln=[Bodenstacheln](../../fanwerk/zauber/bodenstacheln.md)
Botenteufel=[Botenteufel](../../fanwerk/zauber/botenteufel.md)
Botschaft=[Botschaft](../../grw/zauber/botschaft.md)
Brimborium=[Brimborium](../../fanwerk/zauber/brimborium.md)
Chaoszauber=[Chaoszauber](../../fanwerk/zauber/chaoszauber.md)
Dämonen beschwören=[Dämonen beschwören](../../grw/zauber/daemonen-beschwoeren.md)
Dämonenzauber=[Dämonenzauber](../../grw/talente/daemonenzauber.md)
De-Evolution=[De-Evolution](../../fanwerk/zauber/de-evolution.md)
Doppelgänger 1=[Doppelgänger 1](../../fanwerk/zauber/doppelgaenger-1.md)
Doppelgänger 2=[Doppelgänger 2](../../fanwerk/zauber/doppelgaenger-2.md)
Dornenwuchs=[Dornenwuchs](../../fanwerk/zauber/dornenwuchs.md)
Duftnote=[Duftnote](../../grw/zauber/duftnote.md)
Duldgnomischer Zaubertechniker=[Duldgnomischer Zaubertechniker](../../fanwerk/bestiarium/duldgnomischer-zaubertechniker.md)
Dunkelheit spüren=[Dunkelheit spüren](../../fanwerk/zauber/dunkelheit-spueren.md)
Dunkle Segnung=[Dunkle Segnung](../../fanwerk/zauber/dunkle-segnung.md)
Durchlässig=[Durchlässig](../../grw/zauber/durchlaessig.md)
Durchsicht=[Durchsicht](../../grw/zauber/durchsicht.md)
Ebene erschaffen=[Ebene erschaffen](../../fanwerk/zauber/ebene-erschaffen.md)
Ebenensprung=[Ebenensprung](../../fanwerk/zauber/ebenensprung.md)
Ebenentor=[Ebenentor](../../grw/zauber/ebenentor.md)
Edelsteinbombe=[Edelsteinbombe](../../fanwerk/zauber/edelsteinbombe.md)
Edelsteinfalle=[Edelsteinfalle](../../fanwerk/zauber/edelsteinfalle.md)
Eigenschaften erkennen=[Eigenschaften erkennen](../../fanwerk/zauber/eigenschaften-erkennen.md)
Eigenschaft erhöhen=[Eigenschaft erhöhen](../../fanwerk/zauber/eigenschaft-erhoehen.md)
Eigenschaft stärken=[Eigenschaft stärken](../../fanwerk/zauber/eigenschaft-staerken.md)
Eigenschaft verbessern=[Eigenschaft verbessern](../../fanwerk/zauber/eigenschaft-verbessern.md)
Einschläfern=[Einschläfern](../../grw/zauber/einschlaefern.md)
Eisengestalt=[Eisengestalt](../../fanwerk/zauber/eisengestalt.md)
Eiswand=[Eiswand](../../fanwerk/zauber/eiswand.md)
Elementar herbeirufen=[Elementar herbeirufen](../../grw/zauber/elementar-herbeirufen.md)
Elementarschutz=[Elementarschutz](../../fanwerk/zauber/elementarschutz.md)
Elementarsinn=[Elementarsinn](../../fanwerk/zauber/elementarsinn.md)
Entfesseln=[Entfesseln](../../fanwerk/zauber/entfesseln.md)
Enthüllende Aura=[Enthüllende Aura](../../fanwerk/zauber/enthuellende-aura.md)
Entkörpern=[Entkörpern](../../fanwerk/zauber/entkoerpern.md)
Entsteinern=[Entsteinern](../../fanwerk/zauber/entsteinern.md)
Entweihen=[Entweihen](../../fanwerk/zauber/entweihen.md)
Entzaubern=[Entzaubern](../../fanwerk/zauber/entzaubern.md)
Erdspalt=[Erdspalt](../../grw/zauber/erdspalt.md)
Erholsames Nickerchen=[Erholsames Nickerchen](../../fanwerk/zauber/erholsames-nickerchen.md)
Erzwungenes Vergrössern=[Erzwungenes Vergrössern](../../fanwerk/zauber/erzwungenes-vergroessern.md)
Erzwungenes Verkleinern=[Erzwungenes Verkleinern](../../fanwerk/zauber/erzwungenes-verkleinern.md)
Erzwungenes Versetzen=[Erzwungenes Versetzen](../../fanwerk/zauber/erzwungenes-versetzen.md)
Explosiver Teleport=[Explosiver Teleport](../../fanwerk/zauber/explosiver-teleport.md)
Fähigkeiten erkennen=[Fähigkeiten erkennen](../../fanwerk/zauber/faehigkeiten-erkennen.md)
Falsche Magie=[Falsche Magie](../../fanwerk/zauber/falsche-magie.md)
Fata Morgana=[Fata Morgana](../../fanwerk/zauber/fata-morgana.md)
Faulbauchmaden erwecken=[Faulbauchmaden erwecken](../../fanwerk/zauber/faulbauchmaden-erwecken.md)
Federgleich=[Federgleich](../../grw/zauber/federgleich.md)
Feldsegen=[Feldsegen](../../fanwerk/zauber/feldsegen.md)
Feueratem=[Feueratem](../../grw/zauber/feueratem.md)
Feuerball=[Feuerball](../../grw/zauber/feuerball.md)
Feuerlanze=[Feuerlanze](../../grw/zauber/feuerlanze.md)
Feuer löschen=[Feuer löschen](../../fanwerk/zauber/feuer-loeschen.md)
Feuerschutz=[Feuerschutz](../../fanwerk/zauber/feuerschutz.md)
Feuerstrahl=[Feuerstrahl](../../grw/zauber/feuerstrahl.md)
Feuerwand=[Feuerwand](../../grw/zauber/feuerwand.md)
Flackern=[Flackern](../../grw/zauber/flackern.md)
Flammenaura=[Flammenaura](../../fanwerk/zauber/flammenaura.md)
Flammeninferno=[Flammeninferno](../../grw/zauber/flammeninferno.md)
Flammenklinge=[Flammenklinge](../../grw/zauber/flammenklinge.md)
Flammensphären=[Flammensphären](../../fanwerk/zauber/flammensphaeren.md)
Fliegen=[Fliegen](../../grw/zauber/fliegen.md)
Fluch=[Fluch](../../grw/zauber/fluch.md)
Freizauber=[Freizauber](../../fanwerk/zauber/freizauber.md)
Freund=[Freund](../../grw/zauber/freund.md)
Frostschock=[Frostschock](../../grw/zauber/frostschock.md)
Frostwaffe=[Frostwaffe](../../grw/zauber/frostwaffe.md)
Furcht bannen=[Furcht bannen](../../fanwerk/zauber/furcht-bannen.md)
Gasgestalt=[Gasgestalt](../../grw/zauber/gasgestalt.md)
Gaukelei=[Gaukelei](../../fanwerk/zauber/gaukelei.md)
Geben und Nehmen=[Geben und Nehmen](../../grw/zauber/geben-und-nehmen.md)
Gedächtnislöschung=[Gedächtnislöschung](../../fanwerk/zauber/gedaechtnisloeschung.md)
Gedankenleere=[Gedankenleere](../../fanwerk/zauber/gedankenleere.md)
Gedanken lesen=[Gedanken lesen](../../fanwerk/zauber/gedanken-lesen.md)
Gedankenzehrerstrahl=[Gedankenzehrerstrahl](../../fanwerk/zauber/gedankenzehrerstrahl.md)
Gefahrensinn=[Gefahrensinn](../../fanwerk/zauber/gefahrensinn.md)
Gegenstand entdecken=[Gegenstand entdecken](../../fanwerk/zauber/gegenstand-entdecken.md)
Gegner fernhalten=[Gegner fernhalten](../../fanwerk/zauber/gegner-fernhalten.md)
Geheimtür=[Geheimtür](../../fanwerk/zauber/geheimtuer.md)
Gehorche=[Gehorche](../../grw/zauber/gehorche.md)
Geisterklinge=[Geisterklinge](../../fanwerk/zauber/geisterklinge.md)
Geisterlanze=[Geisterlanze](../../fanwerk/zauber/geisterlanze.md)
Geisterpfeil=[Geisterpfeil](../../fanwerk/zauber/geisterpfeil.md)
Geistige Verbindung=[Geistige Verbindung](../../fanwerk/zauber/geistige-verbindung.md)
Geist leeren=[Geist leeren](../../fanwerk/zauber/geist-leeren.md)
Gerinnsel=[Gerinnsel](../../fanwerk/zauber/gerinnsel.md)
Gestalt verändern=[Gestalt verändern](../../fanwerk/zauber/gestalt-veraendern.md)
Gestaltwandeln=[Gestaltwandeln](../../fanwerk/zauber/gestaltwandeln.md)
Gestrüpp=[Gestrüpp](../../fanwerk/zauber/gestruepp.md)
Geteiltes Leben=[Geteiltes Leben](../../fanwerk/zauber/geteiltes-leben.md)
Geysir=[Geysir](../../fanwerk/zauber/geysir.md)
Giftbann=[Giftbann](../../grw/zauber/giftbann.md)
Giftgasgestalt=[Giftgasgestalt](../../fanwerk/zauber/giftgasgestalt.md)
Giftklinge=[Giftklinge](../../fanwerk/zauber/giftklinge.md)
Giftlanze=[Giftlanze](../../fanwerk/zauber/giftlanze.md)
Giftschutz=[Giftschutz](../../grw/zauber/giftschutz.md)
Giftstrahl=[Giftstrahl](../../fanwerk/zauber/giftstrahl.md)
Gift verstärken=[Gift verstärken](../../fanwerk/zauber/gift-verstaerken.md)
Glaube mir=[Glaube mir](../../fanwerk/zauber/glaube-mir.md)
Glücksklinge=[Glücksklinge](../../fanwerk/zauber/gluecksklinge.md)
Glücksschild=[Glücksschild](../../fanwerk/zauber/gluecksschild.md)
Glühender Glaube=[Glühender Glaube](../../grw/zauber/gluehender-glaube.md)
Gnädiger Zauberer=[Gnädiger Zauberer](../../fanwerk/talente/gnaediger-zauberer.md)
Golem erwecken=[Golem erwecken](../../fanwerk/zauber/golem-erwecken.md)
Granaten erschaffen=[Granaten erschaffen](../../fanwerk/zauber/granaten-erschaffen.md)
Grosses Ablenken=[Grosses Ablenken](../../fanwerk/zauber/grosses-ablenken.md)
Grosses Schwächen=[Grosses Schwächen](../../fanwerk/zauber/grosses-schwaechen.md)
Grosses Stören=[Grosses Stören](../../fanwerk/zauber/grosses-stoeren.md)
Grosse Unsichtbarkeit=[Grosse Unsichtbarkeit](../../fanwerk/zauber/grosse-unsichtbarkeit.md)
Grube=[Grube](../../fanwerk/zauber/grube.md)
Halt=[Halt](../../grw/zauber/halt.md)
Harpunieren=[Harpunieren](../../fanwerk/zauber/harpunieren.md)
Hast=[Hast](../../fanwerk/zauber/hast.md)
Häuten=[Häuten](../../fanwerk/zauber/haeuten.md)
Heilbeeren=[Heilbeeren](../../grw/zauber/heilbeeren.md)
Heilende Aura=[Heilende Aura](../../grw/zauber/heilende-aura.md)
Heilende Hand=[Heilende Hand](../../grw/zauber/heilende-hand.md)
Heilende Rune=[Heilende Rune](../../fanwerk/zauber/heilende-rune.md)
Heilendes Feld=[Heilendes Feld](../../grw/zauber/heilendes-feld.md)
Heilendes Gift=[Heilendes Gift](../../fanwerk/zauber/heilendes-gift.md)
Heilendes Licht=[Heilendes Licht](../../grw/zauber/heilendes-licht.md)
Heilende Sphäre=[Heilende Sphäre](../../fanwerk/zauber/heilende-sphaere.md)
Heilende Strahlen=[Heilende Strahlen](../../grw/zauber/heilende-strahlen.md)
Heiliger Hammer=[Heiliger Hammer](../../grw/zauber/heiliger-hammer.md)
Heiligtum=[Heiligtum](../../fanwerk/zauber/heiligtum.md)
Heiltrank verderben=[Heiltrank verderben](../../fanwerk/zauber/heiltrank-verderben.md)
Heilungsraub=[Heilungsraub](../../fanwerk/zauber/heilungsraub.md)
Heilung stoppen=[Heilung stoppen](../../fanwerk/zauber/heilung-stoppen.md)
Heilung verhindern=[Heilung verhindern](../../fanwerk/zauber/heilung-verhindern.md)
Heimvorteil=[Heimvorteil](../../fanwerk/zauber/heimvorteil.md)
Heldentum=[Heldentum](../../fanwerk/zauber/heldentum.md)
Heranziehen=[Heranziehen](../../fanwerk/zauber/heranziehen.md)
Hiergeblieben=[Hiergeblieben](../../fanwerk/zauber/hiergeblieben.md)
Höheren Dämon rufen=[Höheren Dämon rufen](../../fanwerk/zauber/hoeheren-daemon-rufen.md)
Höllenhund rufen=[Höllenhund rufen](../../fanwerk/zauber/hoellenhund-rufen.md)
Holzfäule=[Holzfäule](../../fanwerk/zauber/holzfaeule.md)
Holz formen=[Holz formen](../../fanwerk/zauber/holz-formen.md)
Hungriger Schatten=[Hungriger Schatten](../../fanwerk/zauber/hungriger-schatten.md)
Illusionswand=[Illusionswand](../../fanwerk/zauber/illusionswand.md)
Inquisition=[Inquisition](../../fanwerk/zauber/inquisition.md)
Kadaverexplosion=[Kadaverexplosion](../../fanwerk/zauber/kadaverexplosion.md)
Kampfdämon rufen=[Kampfdämon rufen](../../fanwerk/zauber/kampfdaemon-rufen.md)
Kauderwelsch=[Kauderwelsch](../../fanwerk/zauber/kauderwelsch.md)
Kettenblitz=[Kettenblitz](../../grw/zauber/kettenblitz.md)
Klauenhände=[Klauenhände](../../fanwerk/zauber/klauenhaende.md)
Klebefaden=[Klebefaden](../../fanwerk/zauber/klebefaden.md)
Kleiner Terror=[Kleiner Terror](../../grw/zauber/kleiner-terror.md)
Kleine Unsichtbarkeit=[Kleine Unsichtbarkeit](../../fanwerk/zauber/kleine-unsichtbarkeit.md)
Klettern=[Klettern](../../fanwerk/zauber/klettern.md)
Klingenwand=[Klingenwand](../../fanwerk/zauber/klingenwand.md)
Konstrukt kapern=[Konstrukt kapern](../../fanwerk/zauber/konstrukt-kapern.md)
Kontrollieren=[Kontrollieren](../../grw/zauber/kontrollieren.md)
Kopieren=[Kopieren](../../fanwerk/zauber/kopieren.md)
Körperexplosion=[Körperexplosion](../../grw/zauber/koerperexplosion.md)
Kriegsdämon rufen=[Kriegsdämon rufen](../../fanwerk/zauber/kriegsdaemon-rufen.md)
Kriegszauberer=[Kriegszauberer](../../grw/charaktere-heldenklassen-kriegszauberer.md)
Kugelblitz=[Kugelblitz](../../fanwerk/zauber/kugelblitz.md)
Labyrinth=[Labyrinth](../../fanwerk/zauber/labyrinth.md)
Lach=[Lach](../../fanwerk/zauber/lach.md)
Landbeine=[Landbeine](../../fanwerk/zauber/landbeine.md)
Langer Feueratem=[Langer Feueratem](../../fanwerk/zauber/langer-feueratem.md)
Lauschen=[Lauschen](../../grw/zauber/lauschen.md)
Lavaspalt=[Lavaspalt](../../fanwerk/zauber/lavaspalt.md)
Lavawand=[Lavawand](../../fanwerk/zauber/lavawand.md)
Lebensblick=[Lebensblick](../../fanwerk/zauber/lebensblick.md)
Lebensfeuer=[Lebensfeuer](../../fanwerk/zauber/lebensfeuer.md)
Lebenssauger=[Lebenssauger](../../fanwerk/zauber/lebenssauger.md)
Lebensschild=[Lebensschild](../../fanwerk/zauber/lebensschild.md)
Lebensspende=[Lebensspende](../../fanwerk/zauber/lebensspende.md)
Leibwächter=[Leibwächter](../../fanwerk/zauber/leibwaechter.md)
Leidteiler=[Leidteiler](../../fanwerk/zauber/leidteiler.md)
Letzter Stand=[Letzter Stand](../../fanwerk/zauber/letzter-stand.md)
Lichtexplosion=[Lichtexplosion](../../fanwerk/zauber/lichtexplosion.md)
Licht=[Licht](../../grw/zauber/licht.md)
Lichtlanze=[Lichtlanze](../../grw/zauber/lichtlanze.md)
Lichtodem=[Lichtodem](../../fanwerk/zauber/lichtodem.md)
Lichtpfeil=[Lichtpfeil](../../grw/zauber/lichtpfeil.md)
Lichtsäule=[Lichtsäule](../../grw/zauber/lichtsaeule.md)
Licht spüren=[Licht spüren](../../fanwerk/zauber/licht-spueren.md)
Lieblingszauber=[Lieblingszauber](../../fanwerk/talente/lieblingszauber.md)
Lockruf=[Lockruf](../../fanwerk/zauber/lockruf.md)
Lokalisieren=[Lokalisieren](../../fanwerk/zauber/lokalisieren.md)
Lügen spüren=[Lügen spüren](../../fanwerk/zauber/luegen-spueren.md)
Mächtiges Ablenken=[Mächtiges Ablenken](../../fanwerk/zauber/maechtiges-ablenken.md)
Mächtiges Schwächen=[Mächtiges Schwächen](../../fanwerk/zauber/maechtiges-schwaechen.md)
Mächtiges Stören=[Mächtiges Stören](../../fanwerk/zauber/maechtiges-stoeren.md)
Magie bannen=[Magie bannen](../../grw/zauber/magie-bannen.md)
Magie entdecken=[Magie entdecken](../../grw/zauber/magie-entdecken.md)
Magie identifizieren=[Magie identifizieren](../../grw/zauber/magie-identifizieren.md)
Magieresistenz=[Magieresistenz](../../fanwerk/zauber/magieresistenz.md)
Magische Barriere=[Magische Barriere](../../grw/zauber/magische-barriere.md)
Magische Faust=[Magische Faust](../../fanwerk/zauber/magische-faust.md)
Magische Lafette=[Magische Lafette](../../fanwerk/zauber/magische-lafette.md)
Magischer Blick=[Magischer Blick](../../fanwerk/zauber/magischer-blick.md)
Magische Rüstung=[Magische Rüstung](../../grw/zauber/magische-ruestung.md)
Magisches leuchten=[Magisches leuchten](../../fanwerk/zauber/magisches-leuchten.md)
Magisches Schloss=[Magisches Schloss](../../grw/zauber/magisches-schloss.md)
Magische Waffe=[Magische Waffe](../../grw/zauber/magische-waffe.md)
Magische Wand=[Magische Wand](../../fanwerk/zauber/magische-wand.md)
Magnetischer Schild=[Magnetischer Schild](../../fanwerk/zauber/magnetischer-schild.md)
Manabrot=[Manabrot](../../grw/zauber/manabrot.md)
Manaentzug=[Manaentzug](../../fanwerk/zauber/manaentzug.md)
Mana geben und Nehmen=[Mana geben und Nehmen](../../fanwerk/zauber/mana-geben-und-nehmen.md)
Manakratzer=[Manakratzer](../../fanwerk/zauber/manakratzer.md)
Manaraub=[Manaraub](../../fanwerk/zauber/manaraub.md)
Märtyrer=[Märtyrer](../../fanwerk/zauber/maertyrer.md)
Metall erhitzen oder abkühlen=[Metall erhitzen oder abkühlen](../../fanwerk/zauber/metall-erhitzen-oder-abkuehlen.md)
Metall formen=[Metall formen](../../fanwerk/zauber/metall-formen.md)
Meteor=[Meteor](../../fanwerk/zauber/meteor.md)
Minderer Schutz=[Minderer Schutz](../../fanwerk/zauber/minderer-schutz.md)
Mumie erwecken=[Mumie erwecken](../../fanwerk/zauber/mumie-erwecken.md)
Nahrung zaubern=[Nahrung zaubern](../../grw/zauber/nahrung-zaubern.md)
Netz=[Netz](../../grw/zauber/netz.md)
Niederer Dämon rufen=[Niederer Dämon rufen](../../fanwerk/zauber/niederer-daemon-rufen.md)
Niesanfall=[Niesanfall](../../grw/zauber/niesanfall.md)
Objekt der Begierde=[Objekt der Begierde](../../fanwerk/zauber/objekt-der-begierde.md)
Objekt lesen=[Objekt lesen](../../fanwerk/zauber/objekt-lesen.md)
Öffnen=[Öffnen](../../grw/zauber/oeffnen.md)
Ogergestalt=[Ogergestalt](../../fanwerk/zauber/ogergestalt.md)
Pein=[Pein](../../fanwerk/zauber/pein.md)
Pfadfinder=[Pfadfinder](../../fanwerk/zauber/pfadfinder.md)
Phantom=[Phantom](../../fanwerk/zauber/phantom.md)
Privatgespräch=[Privatgespräch](../../fanwerk/zauber/privatgespraech.md)
Prophezeihung=[Prophezeihung](../../fanwerk/zauber/prophezeihung.md)
Putzteufel=[Putzteufel](../../grw/zauber/putzteufel.md)
Radau=[Radau](../../fanwerk/zauber/radau.md)
Rankenwaffe=[Rankenwaffe](../../fanwerk/zauber/rankenwaffe.md)
Rätselstimme=[Rätselstimme](../../fanwerk/zauber/raetselstimme.md)
Rattling Giftzauberer=[Rattling Giftzauberer](../../fanwerk/bestiarium/rattling-giftzauberer.md)
Regeneration=[Regeneration](../../fanwerk/zauber/regeneration.md)
Reinigen=[Reinigen](../../grw/zauber/reinigen.md)
Riesengestalt=[Riesengestalt](../../fanwerk/zauber/riesengestalt.md)
Rost=[Rost](../../grw/zauber/rost.md)
Ruf des Lichts=[Ruf des Lichts](../../fanwerk/zauber/ruf-des-lichts.md)
Rune des Lebens=[Rune des Lebens](../../fanwerk/zauber/rune-des-lebens.md)
Rüstung des Lichts=[Rüstung des Lichts](../../fanwerk/zauber/ruestung-des-lichts.md)
Rüstung verzaubern=[Rüstung verzaubern](../../fanwerk/zauber/ruestung-verzaubern.md)
Rüstzauberer=[Rüstzauberer](../../grw/talente/ruestzauberer.md)
Sandgrab=[Sandgrab](../../fanwerk/zauber/sandgrab.md)
Sandlanze=[Sandlanze](../../fanwerk/zauber/sandlanze.md)
Sandodem=[Sandodem](../../fanwerk/zauber/sandodem.md)
Sandschild=[Sandschild](../../fanwerk/zauber/sandschild.md)
Sandstrahl=[Sandstrahl](../../fanwerk/zauber/sandstrahl.md)
Sandsturm=[Sandsturm](../../fanwerk/zauber/sandsturm.md)
Sandwoge=[Sandwoge](../../fanwerk/zauber/sandwoge.md)
Säureatem=[Säureatem](../../fanwerk/zauber/saeureatem.md)
Säurelanze=[Säurelanze](../../fanwerk/zauber/saeurelanze.md)
Säurenebel=[Säurenebel](../../fanwerk/zauber/saeurenebel.md)
Säurestrahl=[Säurestrahl](../../fanwerk/zauber/saeurestrahl.md)
Schatten erwecken=[Schatten erwecken](../../grw/zauber/schatten-erwecken.md)
Schattenexplosion=[Schattenexplosion](../../fanwerk/zauber/schattenexplosion.md)
Schatten=[Schatten](../../grw/zauber/schatten.md)
Schattenklinge=[Schattenklinge](../../grw/zauber/schattenklinge.md)
Schattenlanze=[Schattenlanze](../../grw/zauber/schattenlanze.md)
Schattenmantel=[Schattenmantel](../../fanwerk/zauber/schattenmantel.md)
Schattenodem=[Schattenodem](../../fanwerk/zauber/schattenodem.md)
Schattenpfeil=[Schattenpfeil](../../grw/zauber/schattenpfeil.md)
Schattenrüstung=[Schattenrüstung](../../fanwerk/zauber/schattenruestung.md)
Schattensäule=[Schattensäule](../../grw/zauber/schattensaeule.md)
Schimmerross rufen=[Schimmerross rufen](../../fanwerk/zauber/schimmerross-rufen.md)
Schleimwand=[Schleimwand](../../fanwerk/zauber/schleimwand.md)
Schleudern=[Schleudern](../../grw/zauber/schleudern.md)
Schmierfleck=[Schmierfleck](../../fanwerk/zauber/schmierfleck.md)
Schnellzaubern=[Schnellzaubern](../../fanwerk/talente/schnellzaubern.md)
Schock=[Schock](../../fanwerk/zauber/schock.md)
Schockwaffe=[Schockwaffe](../../fanwerk/zauber/schockwaffe.md)
Schreckensklinge=[Schreckensklinge](../../fanwerk/zauber/schreckensklinge.md)
Schützende Schatten=[Schützende Schatten](../../fanwerk/zauber/schuetzende-schatten.md)
Schutz=[Schutz](../../fanwerk/zauber/schutz.md)
Schutzfeld=[Schutzfeld](../../grw/zauber/schutzfeld.md)
Schutzkreis gegen Tiere=[Schutzkreis gegen Tiere](../../fanwerk/zauber/schutzkreis-gegen-tiere.md)
Schutzkuppel=[Schutzkuppel](../../grw/zauber/schutzkuppel.md)
Schutzschild dehnen=[Schutzschild dehnen](../../grw/zauber/schutzschild-dehnen.md)
Schutzschild=[Schutzschild](../../grw/zauber/schutzschild.md)
Schutzschild stärken=[Schutzschild stärken](../../grw/zauber/schutzschild-staerken.md)
Schutz vor Dunkelheit=[Schutz vor Dunkelheit](../../fanwerk/zauber/schutz-vor-dunkelheit.md)
Schutz vor Licht=[Schutz vor Licht](../../fanwerk/zauber/schutz-vor-licht.md)
Schwächender Zauber=[Schwächender Zauber](../../fanwerk/talente/schwaechender-zauber.md)
Schwächen=[Schwächen](../../fanwerk/zauber/schwaechen.md)
Schwarm herbeirufen=[Schwarm herbeirufen](../../fanwerk/zauber/schwarm-herbeirufen.md)
Schwebender Spiegel=[Schwebender Spiegel](../../fanwerk/zauber/schwebender-spiegel.md)
Schwebende Schutzsphäre=[Schwebende Schutzsphäre](../../fanwerk/zauber/schwebende-schutzsphaere.md)
Schweben=[Schweben](../../grw/zauber/schweben.md)
Schweig=[Schweig](../../grw/zauber/schweig.md)
Schwerkraftfeld=[Schwerkraftfeld](../../fanwerk/zauber/schwerkraftfeld.md)
Schwerkraft umkehren=[Schwerkraft umkehren](../../fanwerk/zauber/schwerkraft-umkehren.md)
Schwimmen=[Schwimmen](../../fanwerk/zauber/schwimmen.md)
Seelengefäss=[Seelengefäss](../../fanwerk/zauber/seelengefaess.md)
Segen=[Segen](../../grw/zauber/segen.md)
Selbstheilung=[Selbstheilung](../../fanwerk/zauber/selbstheilung.md)
Seuchenschneide=[Seuchenschneide](../../fanwerk/zauber/seuchenschneide.md)
Sichtverbindung=[Sichtverbindung](../../fanwerk/zauber/sichtverbindung.md)
Sinne schärfen=[Sinne schärfen](../../fanwerk/zauber/sinne-schaerfen.md)
Skelette erwecken=[Skelette erwecken](../../grw/zauber/skelette-erwecken.md)
Slayerwaffe=[Slayerwaffe](../../fanwerk/zauber/slayerwaffe.md)
Sonar=[Sonar](../../fanwerk/zauber/sonar.md)
Spähposten=[Spähposten](../../fanwerk/zauber/spaehposten.md)
Spektakel=[Spektakel](../../fanwerk/zauber/spektakel.md)
Spiegelbild=[Spiegelbild](../../fanwerk/zauber/spiegelbild.md)
Spionage=[Spionage](../../grw/zauber/spionage.md)
Sprache verstehen=[Sprache verstehen](../../fanwerk/zauber/sprache-verstehen.md)
Springen=[Springen](../../grw/zauber/springen.md)
Spurt=[Spurt](../../grw/zauber/spurt.md)
Spur verwischen=[Spur verwischen](../../fanwerk/zauber/spur-verwischen.md)
Stasis=[Stasis](../../fanwerk/zauber/stasis.md)
Stein formen=[Stein formen](../../fanwerk/zauber/stein-formen.md)
Steingestalt=[Steingestalt](../../fanwerk/zauber/steingestalt.md)
Steinverschmelzung=[Steinverschmelzung](../../fanwerk/zauber/steinverschmelzung.md)
Steinwaffe=[Steinwaffe](../../fanwerk/zauber/steinwaffe.md)
Steinwand=[Steinwand](../../grw/zauber/steinwand.md)
Stimme ändern=[Stimme ändern](../../fanwerk/zauber/stimme-aendern.md)
Stimme der Finsternis=[Stimme der Finsternis](../../fanwerk/zauber/stimme-der-finsternis.md)
Stinkbombe=[Stinkbombe](../../fanwerk/zauber/stinkbombe.md)
Stolpern=[Stolpern](../../grw/zauber/stolpern.md)
Stören=[Stören](../../fanwerk/zauber/stoeren.md)
Stossgebet=[Stossgebet](../../grw/zauber/stossgebet.md)
Suggestion=[Suggestion](../../fanwerk/zauber/suggestion.md)
Talente erkennen=[Talente erkennen](../../fanwerk/zauber/talente-erkennen.md)
Talentzauber 1=[Talentzauber 1](../../fanwerk/zauber/talentzauber-1.md)
Talentzauber 2=[Talentzauber 2](../../fanwerk/zauber/talentzauber-2.md)
Tanz=[Tanz](../../grw/zauber/tanz.md)
Tarnender Nebel=[Tarnender Nebel](../../grw/zauber/tarnender-nebel.md)
Tarnung=[Tarnung](../../fanwerk/zauber/tarnung.md)
Telekinese=[Telekinese](../../grw/zauber/telekinese.md)
Telekinetischer Wurf=[Telekinetischer Wurf](../../fanwerk/zauber/telekinetischer-wurf.md)
Telepathie=[Telepathie](../../fanwerk/zauber/telepathie.md)
Teleport=[Teleport](../../grw/zauber/teleport.md)
Tentakelranken=[Tentakelranken](../../fanwerk/zauber/tentakelranken.md)
Terror=[Terror](../../grw/zauber/terror.md)
Teufelchen rufen=[Teufelchen rufen](../../fanwerk/zauber/teufelchen-rufen.md)
Thema finden=[Thema finden](../../fanwerk/zauber/thema-finden.md)
Tierbeherrschung=[Tierbeherrschung](../../grw/zauber/tierbeherrschung.md)
Tiere besänftigen=[Tiere besänftigen](../../grw/zauber/tiere-besaenftigen.md)
Tiere fernhalten=[Tiere fernhalten](../../fanwerk/zauber/tiere-fernhalten.md)
Tier oder Pflanze herbeirufen=[Tier oder Pflanze herbeirufen](../../fanwerk/zauber/tier-oder-pflanze-herbeirufen.md)
Tiersprache=[Tiersprache](../../fanwerk/zauber/tiersprache.md)
Todesklinge=[Todesklinge](../../fanwerk/zauber/todesklinge.md)
Todesschutz=[Todesschutz](../../fanwerk/zauber/todesschutz.md)
Totemtier=[Totemtier](../../fanwerk/zauber/totemtier.md)
Totengespräch=[Totengespräch](../../grw/zauber/totengespraech.md)
Totenklage=[Totenklage](../../fanwerk/zauber/totenklage.md)
Totenwache=[Totenwache](../../fanwerk/zauber/totenwache.md)
Trägheit=[Trägheit](../../fanwerk/zauber/traegheit.md)
Traumzauber=[Traumzauber](../../fanwerk/zauber/traumzauber.md)
Treibsand=[Treibsand](../../fanwerk/zauber/treibsand.md)
Trollgestalt=[Trollgestalt](../../fanwerk/zauber/trollgestalt.md)
Trugbild=[Trugbild](../../grw/zauber/trugbild.md)
Übersicht über alle Zaubersprüche=[Übersicht über alle Zaubersprüche](index-zauber.md)
Unsichtbares Sehen=[Unsichtbares Sehen](../../grw/zauber/unsichtbares-sehen.md)
Unsichtbarkeit=[Unsichtbarkeit](../../grw/zauber/unsichtbarkeit.md)
Unverwundbarkeit=[Unverwundbarkeit](../../fanwerk/zauber/unverwundbarkeit.md)
Vampirfäuste=[Vampirfäuste](../../fanwerk/zauber/vampirfaeuste.md)
Vampirische Heilung=[Vampirische Heilung](../../fanwerk/zauber/vampirische-heilung.md)
Vampirklinge=[Vampirklinge](../../fanwerk/zauber/vampirklinge.md)
Verarbeiten=[Verarbeiten](../../fanwerk/zauber/verarbeiten.md)
Verbergende Aura=[Verbergende Aura](../../fanwerk/zauber/verbergende-aura.md)
Verbesserte Magische Faust=[Verbesserte Magische Faust](../../fanwerk/zauber/verbesserte-magische-faust.md)
Verbesserte Magische Waffe=[Verbesserte Magische Waffe](../../fanwerk/zauber/verbesserte-magische-waffe.md)
Verbessertes Ablenken=[Verbessertes Ablenken](../../fanwerk/zauber/verbessertes-ablenken.md)
Verbesserte Selbstheilung=[Verbesserte Selbstheilung](../../fanwerk/zauber/verbesserte-selbstheilung.md)
Verbessertes Schwächen=[Verbessertes Schwächen](../../fanwerk/zauber/verbessertes-schwaechen.md)
Verbessertes Stören=[Verbessertes Stören](../../fanwerk/zauber/verbessertes-stoeren.md)
Verborgene Illusion=[Verborgene Illusion](../../fanwerk/zauber/verborgene-illusion.md)
Verborgenes sehen=[Verborgenes sehen](../../grw/zauber/verborgenes-sehen.md)
Verbot=[Verbot](../../fanwerk/zauber/verbot.md)
Verdampfen=[Verdampfen](../../grw/zauber/verdampfen.md)
Verdorren=[Verdorren](../../fanwerk/zauber/verdorren.md)
Verflüssigen=[Verflüssigen](../../fanwerk/zauber/verfluessigen.md)
Vergangenes sehen=[Vergangenes sehen](../../fanwerk/zauber/vergangenes-sehen.md)
Vergiss=[Vergiss](../../fanwerk/zauber/vergiss.md)
Vergrössern=[Vergrössern](../../grw/zauber/vergroessern.md)
Verjüngen=[Verjüngen](../../fanwerk/zauber/verjuengen.md)
Verkleinern=[Verkleinern](../../grw/zauber/verkleinern.md)
Verkrüppeln 1=[Verkrüppeln 1](../../fanwerk/zauber/verkrueppeln-1.md)
Verkrüppeln 2=[Verkrüppeln 2](../../fanwerk/zauber/verkrueppeln-2.md)
Verlangen=[Verlangen](../../fanwerk/zauber/verlangen.md)
Verlangsamen=[Verlangsamen](../../grw/zauber/verlangsamen.md)
Verschicken=[Verschicken](../../fanwerk/zauber/verschicken.md)
Verschlinger 1=[Verschlinger 1](../../fanwerk/zauber/verschlinger-1.md)
Verschlinger 2=[Verschlinger 2](../../fanwerk/zauber/verschlinger-2.md)
Verschlinger 3=[Verschlinger 3](../../fanwerk/zauber/verschlinger-3.md)
Verschwinde=[Verschwinde](../../fanwerk/zauber/verschwinde.md)
Versetzen=[Versetzen](../../grw/zauber/versetzen.md)
Versetzte Stimme=[Versetzte Stimme](../../grw/zauber/versetzte-stimme.md)
Verstärkter Schutz=[Verstärkter Schutz](../../fanwerk/zauber/verstaerkter-schutz.md)
Versteinern=[Versteinern](../../fanwerk/zauber/versteinern.md)
Verteidigung=[Verteidigung](../../grw/zauber/verteidigung.md)
Vertrautenzauber=[Vertrautenzauber](../../fanwerk/talente/vertrautenzauber.md)
Vertreiben=[Vertreiben](../../grw/zauber/vertreiben.md)
Verwandlung=[Verwandlung](../../grw/zauber/verwandlung.md)
Verwirren=[Verwirren](../../grw/zauber/verwirren.md)
Verzauberter Besen=[Verzauberter Besen](../../fanwerk/bestiarium/verzauberter-besen.md)
Verzweiflung=[Verzweiflung](../../fanwerk/zauber/verzweiflung.md)
Vier Arme=[Vier Arme](../../fanwerk/zauber/vier-arme.md)
Vision=[Vision](../../fanwerk/zauber/vision.md)
Volksgestalt=[Volksgestalt](../../grw/zauber/volksgestalt.md)
Vor Konstrukten verstecken=[Vor Konstrukten verstecken](../../fanwerk/zauber/vor-konstrukten-verstecken.md)
Vor Tieren verstecken=[Vor Tieren verstecken](../../fanwerk/zauber/vor-tieren-verstecken.md)
Vor Untoten verstecken=[Vor Untoten verstecken](../../fanwerk/zauber/vor-untoten-verstecken.md)
Wächter=[Wächter](../../grw/zauber/waechter.md)
Waffe beleben=[Waffe beleben](../../fanwerk/zauber/waffe-beleben.md)
Waffe des Lichts=[Waffe des Lichts](../../grw/zauber/waffe-des-lichts.md)
Waffe herbeirufen=[Waffe herbeirufen](../../fanwerk/zauber/waffe-herbeirufen.md)
Wahnsinn=[Wahnsinn](../../grw/zauber/wahnsinn.md)
Wand aus Dunkelheit=[Wand aus Dunkelheit](../../fanwerk/zauber/wand-aus-dunkelheit.md)
Wand aus Licht=[Wand aus Licht](../../fanwerk/zauber/wand-aus-licht.md)
Wand der Enthüllung=[Wand der Enthüllung](../../fanwerk/zauber/wand-der-enthuellung.md)
Wandöffnung=[Wandöffnung](../../grw/zauber/wandoeffnung.md)
Wasser atmen=[Wasser atmen](../../fanwerk/zauber/wasser-atmen.md)
Wasser teilen=[Wasser teilen](../../grw/zauber/wasser-teilen.md)
Wasserwandeln=[Wasserwandeln](../../grw/zauber/wasserwandeln.md)
Wasser weihen=[Wasser weihen](../../grw/zauber/wasser-weihen.md)
Wechselzauber=[Wechselzauber](../../grw/zauber/wechselzauber.md)
Weihen=[Weihen](../../fanwerk/zauber/weihen.md)
Wiederbelebung=[Wiederbelebung](../../grw/zauber/wiederbelebung.md)
Wildwuchs=[Wildwuchs](../../fanwerk/zauber/wildwuchs.md)
Wind kontrollieren=[Wind kontrollieren](../../fanwerk/zauber/wind-kontrollieren.md)
Wirbelwind=[Wirbelwind](../../fanwerk/zauber/wirbelwind.md)
Wissen der Welt=[Wissen der Welt](../../fanwerk/zauber/wissen-der-welt.md)
Woge der Zerstörung=[Woge der Zerstörung](../../fanwerk/zauber/woge-der-zerstoerung.md)
Wolke der Ablenkung=[Wolke der Ablenkung](../../fanwerk/zauber/wolke-der-ablenkung.md)
Wolke der Reue=[Wolke der Reue](../../grw/zauber/wolke-der-reue.md)
Wolke der Schwäche=[Wolke der Schwäche](../../fanwerk/zauber/wolke-der-schwaeche.md)
Wolke der Störung=[Wolke der Störung](../../fanwerk/zauber/wolke-der-stoerung.md)
Wolke des Todes=[Wolke des Todes](../../grw/zauber/wolke-des-todes.md)
Wolke des Wahnsinns=[Wolke des Wahnsinns](../../fanwerk/zauber/wolke-des-wahnsinns.md)
Wolkenreise=[Wolkenreise](../../fanwerk/zauber/wolkenreise.md)
Wunde übertragen=[Wunde übertragen](../../fanwerk/zauber/wunde-uebertragen.md)
Wunsch 1=[Wunsch 1](../../fanwerk/zauber/wunsch-1.md)
Wunsch 2=[Wunsch 2](../../fanwerk/zauber/wunsch-2.md)
Wunsch 3=[Wunsch 3](../../fanwerk/zauber/wunsch-3.md)
Würgegriff=[Würgegriff](../../fanwerk/zauber/wuergegriff.md)
Zauberabklang=[Zauberabklang](../../grw/zauber/zauberabklang.md)
Zauber aufheben=[Zauber aufheben](../../fanwerk/zauber/zauber-aufheben.md)
Zauberauge=[Zauberauge](../../fanwerk/zauber/zauberauge.md)
Zauber auslösen=[Zauber auslösen](../../grw/talente/zauber-ausloesen.md)
Zauberbeschleunigung=[Zauberbeschleunigung](../../fanwerk/talente/zauberbeschleunigung.md)
Zauberdehnung=[Zauberdehnung](../../fanwerk/talente/zauberdehnung.md)
Zauber der Wildnis=[Zauber der Wildnis](../../fanwerk/talente/zauber-der-wildnis.md)
Zauberecho=[Zauberecho](../../fanwerk/talente/zauberecho.md)
Zauber einfangen=[Zauber einfangen](../../fanwerk/zauber/zauber-einfangen.md)
Zauberer=[Zauberer](../../grw/charaktere-klasse-zauberer.md)
Zauber erkennen=[Zauber erkennen](../../fanwerk/zauber/zauber-erkennen.md)
Zauber=[Zauber](../../fanwerk/zauber/zauber.md)
Zauberglyphe=[Zauberglyphe](../../fanwerk/zauber/zauberglyphe.md)
Zauberimmunität=[Zauberimmunität](../../fanwerk/zauber/zauberimmunitaet.md)
Zauberkäfig=[Zauberkäfig](../../fanwerk/zauber/zauberkaefig.md)
Zauberleiter=[Zauberleiter](../../grw/zauber/zauberleiter.md)
Zaubermacht=[Zaubermacht](../../grw/talente/zaubermacht.md)
Zauberqual=[Zauberqual](../../grw/talente/zauberqual.md)
Zauberquerschläger=[Zauberquerschläger](../../fanwerk/talente/zauberquerschlaeger.md)
Zauberroutine=[Zauberroutine](../../grw/talente/zauberroutine.md)
Zauberspiegel=[Zauberspiegel](../../fanwerk/zauber/zauberspiegel.md)
Zaubersprüche=[Zaubersprüche](../../grw/zaubersprueche.md)
Zauber stören=[Zauber stören](../../fanwerk/talente/zauber-stoeren.md)
Zaubertrick=[Zaubertrick](../../grw/zauber/zaubertrick.md)
Zauberverbot=[Zauberverbot](../../fanwerk/zauber/zauberverbot.md)
Zauberverlängerung=[Zauberverlängerung](../../fanwerk/talente/zauberverlaengerung.md)
Zauber verleihen=[Zauber verleihen](../../fanwerk/talente/zauber-verleihen.md)
Zauberwaffe=[Zauberwaffe](../../grw/talente/zauberwaffe.md)
Zauberwasser=[Zauberwasser](../../fanwerk/talente/zauberwasser.md)
Zauberwelle=[Zauberwelle](../../fanwerk/talente/zauberwelle.md)
Zauberwirker=[Zauberwirker](../../grw/charaktere-klasse-zauberwirker.md)
Zauberzeichen=[Zauberzeichen](../../fanwerk/zauber/zauberzeichen.md)
Zeitansage=[Zeitansage](../../fanwerk/zauber/zeitansage.md)
Zeitinterferenz=[Zeitinterferenz](../../fanwerk/zauber/zeitinterferenz.md)
Zeitstop=[Zeitstop](../../grw/zauber/zeitstop.md)
Zementieren=[Zementieren](../../fanwerk/zauber/zementieren.md)
Zielmarkierung=[Zielmarkierung](../../fanwerk/zauber/zielmarkierung.md)
Zombies erwecken=[Zombies erwecken](../../grw/zauber/zombies-erwecken.md)
Zone des Friedens=[Zone des Friedens](../../fanwerk/zauber/zone-des-friedens.md)
Zorn des Lichts=[Zorn des Lichts](../../fanwerk/zauber/zorn-des-lichts.md)
Zuflucht=[Zuflucht](../../fanwerk/zauber/zuflucht.md)
Zweites Leben=[Zweites Leben](../../fanwerk/zauber/zweites-leben.md)
Zwergensicht=[Zwergensicht](../../fanwerk/zauber/zwergensicht.md)